Pig3Fw:Pig118Rv	AAGAACTCCGATTGCGAAGGCA	CAGACTTACGTCCATTGACCAA
Pig3Fw:Pig119Rv	AAGAACTCCGATTGCGAAGGCA	GCCGGCCTACGCTCCCTTTAAA
Pig3Fw:Pig120Rv	AAGAACTCCGATTGCGAAGGCA	GGCATTTCACAACACGCTTAAA
Pig3Fw:Pig121Rv	AAGAACTCCGATTGCGAAGGCA	TTATTCATGCGGTACCTGCAAA
Pig4Fw:Pig1Rv	AAGCGTGTTGTGAAATGCCGCG	CCTGCACGCTACTTGGCTGGTT
Pig4Fw:Pig2Rv	AAGCGTGTTGTGAAATGCCGCG	AGCTGCCTTCGCAATCGGAGTT
Pig4Fw:Pig3Rv	AAGCGTGTTGTGAAATGCCGCG	TGCCTTCGCAATCGGAGTTCTT
Pig4Fw:Pig4Rv	AAGCGTGTTGTGAAATGCCGCG	CGCGGCATTTCACAACACGCTT
Pig4Fw:Pig5Rv	AAGCGTGTTGTGAAATGCCGCG	CGATACCCGCACTTTCGAGCTT
Pig4Fw:Pig6Rv	AAGCGTGTTGTGAAATGCCGCG	GGCACGGAATTAGCCGGTCCTT
Pig4Fw:Pig7Rv	AAGCGTGTTGTGAAATGCCGCG	TAACGCTACGGTAAGCTGCCTT
Pig4Fw:Pig8Rv	AAGCGTGTTGTGAAATGCCGCG	GCCGTCATCCTGCACGCTACTT
Pig4Fw:Pig9Rv	AAGCGTGTTGTGAAATGCCGCG	ACGGAATTAGCCGGTCCTTATT
Pig4Fw:Pig10Rv	AAGCGTGTTGTGAAATGCCGCG	CTGGTTCAGACTTACGTCCATT
Pig4Fw:Pig11Rv	AAGCGTGTTGTGAAATGCCGCG	TCCTGCACGCTACTTGGCTGGT
Pig4Fw:Pig12Rv	AAGCGTGTTGTGAAATGCCGCG	TGCTGGCACGGAATTAGCCGGT
Pig4Fw:Pig13Rv	AAGCGTGTTGTGAAATGCCGCG	CCGCACTTTCGAGCTTCAGCGT
Pig4Fw:Pig14Rv	AAGCGTGTTGTGAAATGCCGCG	AGTTTACAACCCATAGGGCCGT
Pig4Fw:Pig15Rv	AAGCGTGTTGTGAAATGCCGCG	CTTGGCTGGTTCAGACTTACGT
Pig4Fw:Pig16Rv	AAGCGTGTTGTGAAATGCCGCG	AAGCTGCCTTCGCAATCGGAGT
Pig4Fw:Pig17Rv	AAGCGTGTTGTGAAATGCCGCG	CTGCCTTCGCAATCGGAGTTCT
Pig4Fw:Pig18Rv	AAGCGTGTTGTGAAATGCCGCG	ATCGGAGTTCTTCGTGATATCT
Pig4Fw:Pig19Rv	AAGCGTGTTGTGAAATGCCGCG	CTTCCGTATTACCGCGGCTGCT
Pig4Fw:Pig20Rv	AAGCGTGTTGTGAAATGCCGCG	TCATCCTGCACGCTACTTGGCT
Pig4Fw:Pig21Rv	AAGCGTGTTGTGAAATGCCGCG	GACCTTCCGTATTACCGCGGCT
Pig4Fw:Pig22Rv	AAGCGTGTTGTGAAATGCCGCG	GATATCTAAGCATTTCACCGCT
Pig4Fw:Pig23Rv	AAGCGTGTTGTGAAATGCCGCG	CCGCGGCATTTCACAACACGCT
Pig4Fw:Pig24Rv	AAGCGTGTTGTGAAATGCCGCG	TGGCACGGAATTAGCCGGTCCT
Pig4Fw:Pig25Rv	AAGCGTGTTGTGAAATGCCGCG	CAACCCATAGGGCCGTCATCCT
Pig4Fw:Pig26Rv	AAGCGTGTTGTGAAATGCCGCG	CGCTACACCACGAATTCCGCCT
Pig4Fw:Pig27Rv	AAGCGTGTTGTGAAATGCCGCG	GGTCCTTATTCATGCGGTACCT
Pig4Fw:Pig28Rv	AAGCGTGTTGTGAAATGCCGCG	ACACCACGAATTCCGCCTACCT
Pig4Fw:Pig29Rv	AAGCGTGTTGTGAAATGCCGCG	CGCTACTTGGCTGGTTCAGACT
Pig4Fw:Pig30Rv	AAGCGTGTTGTGAAATGCCGCG	CACGGAATTAGCCGGTCCTTAT
Pig4Fw:Pig31Rv	AAGCGTGTTGTGAAATGCCGCG	CAATCGGAGTTCTTCGTGATAT
Pig4Fw:Pig32Rv	AAGCGTGTTGTGAAATGCCGCG	CGCAATCGGAGTTCTTCGTGAT
Pig4Fw:Pig33Rv	AAGCGTGTTGTGAAATGCCGCG	TTACAACCCATAGGGCCGTCAT
Pig4Fw:Pig34Rv	AAGCGTGTTGTGAAATGCCGCG	GCTGGTTCAGACTTACGTCCAT
Pig4Fw:Pig35Rv	AAGCGTGTTGTGAAATGCCGCG	TACGGTAAGCTGCCTTCGCAAT
Pig4Fw:Pig36Rv	AAGCGTGTTGTGAAATGCCGCG	CTACGCTCCCTTTAAACCCAAT
Pig4Fw:Pig37Rv	AAGCGTGTTGTGAAATGCCGCG	CCGTCATCCTGCACGCTACTTG
Pig4Fw:Pig38Rv	AAGCGTGTTGTGAAATGCCGCG	TGGTTCAGACTTACGTCCATTG
Pig4Fw:Pig39Rv	AAGCGTGTTGTGAAATGCCGCG	TTCCGTATTACCGCGGCTGCTG
Pig4Fw:Pig40Rv	AAGCGTGTTGTGAAATGCCGCG	CATCCTGCACGCTACTTGGCTG
Pig4Fw:Pig41Rv	AAGCGTGTTGTGAAATGCCGCG	ACCTTCCGTATTACCGCGGCTG
Pig4Fw:Pig42Rv	AAGCGTGTTGTGAAATGCCGCG	AACCCATAGGGCCGTCATCCTG
Pig4Fw:Pig43Rv	AAGCGTGTTGTGAAATGCCGCG	GTCCTTATTCATGCGGTACCTG
Pig4Fw:Pig44Rv	AAGCGTGTTGTGAAATGCCGCG	AATTAGCCGGTCCTTATTCATG
Pig4Fw:Pig45Rv	AAGCGTGTTGTGAAATGCCGCG	CGTCATCCTGCACGCTACTTGG
Pig4Fw:Pig46Rv	AAGCGTGTTGTGAAATGCCGCG	ATCCTGCACGCTACTTGGCTGG
Pig4Fw:Pig47Rv	AAGCGTGTTGTGAAATGCCGCG	AAGCAGTTTACAACCCATAGGG
Pig4Fw:Pig48Rv	AAGCGTGTTGTGAAATGCCGCG	GGTAAGCTGCCTTCGCAATCGG
Pig4Fw:Pig49Rv	AAGCGTGTTGTGAAATGCCGCG	TAGCCGGTCCTTATTCATGCGG
Pig4Fw:Pig50Rv	AAGCGTGTTGTGAAATGCCGCG	AAAGCAGTTTACAACCCATAGG
Pig4Fw:Pig51Rv	AAGCGTGTTGTGAAATGCCGCG	ACGCTACGGTAAGCTGCCTTCG
Pig4Fw:Pig52Rv	AAGCGTGTTGTGAAATGCCGCG	CGGTAAGCTGCCTTCGCAATCG
Pig4Fw:Pig53Rv	AAGCGTGTTGTGAAATGCCGCG	TTAGCCGGTCCTTATTCATGCG
Pig4Fw:Pig54Rv	AAGCGTGTTGTGAAATGCCGCG	CAGTTTACAACCCATAGGGCCG
Pig4Fw:Pig55Rv	AAGCGTGTTGTGAAATGCCGCG	TAAGCTGCCTTCGCAATCGGAG
Pig4Fw:Pig56Rv	AAGCGTGTTGTGAAATGCCGCG	GCACGCTACTTGGCTGGTTCAG
Pig4Fw:Pig57Rv	AAGCGTGTTGTGAAATGCCGCG	TACCCGCACTTTCGAGCTTCAG
Pig4Fw:Pig58Rv	AAGCGTGTTGTGAAATGCCGCG	GGAGTTCTTCGTGATATCTAAG
Pig4Fw:Pig59Rv	AAGCGTGTTGTGAAATGCCGCG	CTGCACGCTACTTGGCTGGTTC
Pig4Fw:Pig60Rv	AAGCGTGTTGTGAAATGCCGCG	GCTGCCTTCGCAATCGGAGTTC
Pig4Fw:Pig61Rv	AAGCGTGTTGTGAAATGCCGCG	GATACCCGCACTTTCGAGCTTC
Pig4Fw:Pig62Rv	AAGCGTGTTGTGAAATGCCGCG	AACGCTACGGTAAGCTGCCTTC
Pig4Fw:Pig63Rv	AAGCGTGTTGTGAAATGCCGCG	CGCACTTTCGAGCTTCAGCGTC
Pig4Fw:Pig64Rv	AAGCGTGTTGTGAAATGCCGCG	GTTTACAACCCATAGGGCCGTC
Pig4Fw:Pig65Rv	AAGCGTGTTGTGAAATGCCGCG	TTGGCTGGTTCAGACTTACGTC
Pig4Fw:Pig66Rv	AAGCGTGTTGTGAAATGCCGCG	CACCACGAATTCCGCCTACCTC
Pig4Fw:Pig67Rv	AAGCGTGTTGTGAAATGCCGCG	AATCGGAGTTCTTCGTGATATC
Pig4Fw:Pig68Rv	AAGCGTGTTGTGAAATGCCGCG	TACAACCCATAGGGCCGTCATC
Pig4Fw:Pig69Rv	AAGCGTGTTGTGAAATGCCGCG	ACGGTAAGCTGCCTTCGCAATC
Pig4Fw:Pig70Rv	AAGCGTGTTGTGAAATGCCGCG	TCCTTATTCATGCGGTACCTGC
Pig4Fw:Pig71Rv	AAGCGTGTTGTGAAATGCCGCG	ATTAGCCGGTCCTTATTCATGC
Pig4Fw:Pig72Rv	AAGCGTGTTGTGAAATGCCGCG	GTCATCCTGCACGCTACTTGGC
Pig4Fw:Pig73Rv	AAGCGTGTTGTGAAATGCCGCG	AGCAGTTTACAACCCATAGGGC
Pig4Fw:Pig74Rv	AAGCGTGTTGTGAAATGCCGCG	TGATATCTAAGCATTTCACCGC
Pig4Fw:Pig75Rv	AAGCGTGTTGTGAAATGCCGCG	ACCCGCACTTTCGAGCTTCAGC
Pig4Fw:Pig76Rv	AAGCGTGTTGTGAAATGCCGCG	GAGTTCTTCGTGATATCTAAGC
Pig4Fw:Pig77Rv	AAGCGTGTTGTGAAATGCCGCG	TGGCTGGTTCAGACTTACGTCC
Pig4Fw:Pig78Rv	AAGCGTGTTGTGAAATGCCGCG	ACCACGAATTCCGCCTACCTCC
Pig4Fw:Pig79Rv	AAGCGTGTTGTGAAATGCCGCG	ACAACCCATAGGGCCGTCATCC
Pig4Fw:Pig80Rv	AAGCGTGTTGTGAAATGCCGCG	GCAGTTTACAACCCATAGGGCC
Pig4Fw:Pig81Rv	AAGCGTGTTGTGAAATGCCGCG	GGCCTACGCTCCCTTTAAACCC
Pig4Fw:Pig82Rv	AAGCGTGTTGTGAAATGCCGCG	TACACCACGAATTCCGCCTACC
Pig4Fw:Pig83Rv	AAGCGTGTTGTGAAATGCCGCG	TTCAGACTTACGTCCATTGACC
Pig4Fw:Pig84Rv	AAGCGTGTTGTGAAATGCCGCG	CGGCCTACGCTCCCTTTAAACC
Pig4Fw:Pig85Rv	AAGCGTGTTGTGAAATGCCGCG	TATCTAAGCATTTCACCGCTAC
Pig4Fw:Pig86Rv	AAGCGTGTTGTGAAATGCCGCG	GTTCAGACTTACGTCCATTGAC
Pig4Fw:Pig87Rv	AAGCGTGTTGTGAAATGCCGCG	ACGCTACTTGGCTGGTTCAGAC
Pig4Fw:Pig88Rv	AAGCGTGTTGTGAAATGCCGCG	TCTAAGCATTTCACCGCTACAC
Pig4Fw:Pig89Rv	AAGCGTGTTGTGAAATGCCGCG	CCGGCCTACGCTCCCTTTAAAC
Pig4Fw:Pig90Rv	AAGCGTGTTGTGAAATGCCGCG	AAGCCGGCCTACGCTCCCTTTA
Pig4Fw:Pig91Rv	AAGCGTGTTGTGAAATGCCGCG	GCGGCATTTCACAACACGCTTA
Pig4Fw:Pig92Rv	AAGCGTGTTGTGAAATGCCGCG	GCACGGAATTAGCCGGTCCTTA
Pig4Fw:Pig93Rv	AAGCGTGTTGTGAAATGCCGCG	TCGGAGTTCTTCGTGATATCTA
Pig4Fw:Pig94Rv	AAGCGTGTTGTGAAATGCCGCG	GCTACACCACGAATTCCGCCTA
Pig4Fw:Pig95Rv	AAGCGTGTTGTGAAATGCCGCG	GCAATCGGAGTTCTTCGTGATA
Pig4Fw:Pig96Rv	AAGCGTGTTGTGAAATGCCGCG	TACGCTCCCTTTAAACCCAATA
Pig4Fw:Pig97Rv	AAGCGTGTTGTGAAATGCCGCG	GGTTCAGACTTACGTCCATTGA
Pig4Fw:Pig98Rv	AAGCGTGTTGTGAAATGCCGCG	TCGCAATCGGAGTTCTTCGTGA
Pig4Fw:Pig99Rv	AAGCGTGTTGTGAAATGCCGCG	GTAAGCTGCCTTCGCAATCGGA
Pig4Fw:Pig100Rv	AAGCGTGTTGTGAAATGCCGCG	CACGCTACTTGGCTGGTTCAGA
Pig4Fw:Pig101Rv	AAGCGTGTTGTGAAATGCCGCG	TGCACGCTACTTGGCTGGTTCA
Pig4Fw:Pig102Rv	AAGCGTGTTGTGAAATGCCGCG	ATACCCGCACTTTCGAGCTTCA
Pig4Fw:Pig103Rv	AAGCGTGTTGTGAAATGCCGCG	GCACTTTCGAGCTTCAGCGTCA
Pig4Fw:Pig104Rv	AAGCGTGTTGTGAAATGCCGCG	TTTACAACCCATAGGGCCGTCA
Pig4Fw:Pig105Rv	AAGCGTGTTGTGAAATGCCGCG	CCTTATTCATGCGGTACCTGCA
Pig4Fw:Pig106Rv	AAGCGTGTTGTGAAATGCCGCG	GCTACGGTAAGCTGCCTTCGCA
Pig4Fw:Pig107Rv	AAGCGTGTTGTGAAATGCCGCG	GGCTGGTTCAGACTTACGTCCA
Pig4Fw:Pig108Rv	AAGCGTGTTGTGAAATGCCGCG	GCCTACGCTCCCTTTAAACCCA
Pig4Fw:Pig109Rv	AAGCGTGTTGTGAAATGCCGCG	TCAGACTTACGTCCATTGACCA
Pig4Fw:Pig110Rv	AAGCGTGTTGTGAAATGCCGCG	ATCTAAGCATTTCACCGCTACA
Pig4Fw:Pig111Rv	AAGCGTGTTGTGAAATGCCGCG	AGCCGGCCTACGCTCCCTTTAA
Pig4Fw:Pig112Rv	AAGCGTGTTGTGAAATGCCGCG	CGGCATTTCACAACACGCTTAA
Pig4Fw:Pig113Rv	AAGCGTGTTGTGAAATGCCGCG	CGGAGTTCTTCGTGATATCTAA
Pig4Fw:Pig114Rv	AAGCGTGTTGTGAAATGCCGCG	ACGCTCCCTTTAAACCCAATAA
Pig4Fw:Pig115Rv	AAGCGTGTTGTGAAATGCCGCG	CTTATTCATGCGGTACCTGCAA
Pig4Fw:Pig116Rv	AAGCGTGTTGTGAAATGCCGCG	CTACGGTAAGCTGCCTTCGCAA
Pig4Fw:Pig117Rv	AAGCGTGTTGTGAAATGCCGCG	CCTACGCTCCCTTTAAACCCAA
Pig4Fw:Pig118Rv	AAGCGTGTTGTGAAATGCCGCG	CAGACTTACGTCCATTGACCAA
Pig4Fw:Pig119Rv	AAGCGTGTTGTGAAATGCCGCG	GCCGGCCTACGCTCCCTTTAAA
Pig4Fw:Pig120Rv	AAGCGTGTTGTGAAATGCCGCG	GGCATTTCACAACACGCTTAAA
Pig4Fw:Pig121Rv	AAGCGTGTTGTGAAATGCCGCG	TTATTCATGCGGTACCTGCAAA
Pig5Fw:Pig1Rv	AAGCTCGAAAGTGCGGGTATCG	CCTGCACGCTACTTGGCTGGTT
Pig5Fw:Pig2Rv	AAGCTCGAAAGTGCGGGTATCG	AGCTGCCTTCGCAATCGGAGTT
Pig5Fw:Pig3Rv	AAGCTCGAAAGTGCGGGTATCG	TGCCTTCGCAATCGGAGTTCTT
Pig5Fw:Pig4Rv	AAGCTCGAAAGTGCGGGTATCG	CGCGGCATTTCACAACACGCTT
Pig5Fw:Pig5Rv	AAGCTCGAAAGTGCGGGTATCG	CGATACCCGCACTTTCGAGCTT
Pig5Fw:Pig6Rv	AAGCTCGAAAGTGCGGGTATCG	GGCACGGAATTAGCCGGTCCTT
Pig5Fw:Pig7Rv	AAGCTCGAAAGTGCGGGTATCG	TAACGCTACGGTAAGCTGCCTT
Pig5Fw:Pig8Rv	AAGCTCGAAAGTGCGGGTATCG	GCCGTCATCCTGCACGCTACTT
Pig5Fw:Pig9Rv	AAGCTCGAAAGTGCGGGTATCG	ACGGAATTAGCCGGTCCTTATT
Pig5Fw:Pig10Rv	AAGCTCGAAAGTGCGGGTATCG	CTGGTTCAGACTTACGTCCATT
Pig5Fw:Pig11Rv	AAGCTCGAAAGTGCGGGTATCG	TCCTGCACGCTACTTGGCTGGT
Pig5Fw:Pig12Rv	AAGCTCGAAAGTGCGGGTATCG	TGCTGGCACGGAATTAGCCGGT
Pig5Fw:Pig13Rv	AAGCTCGAAAGTGCGGGTATCG	CCGCACTTTCGAGCTTCAGCGT
Pig5Fw:Pig14Rv	AAGCTCGAAAGTGCGGGTATCG	AGTTTACAACCCATAGGGCCGT
Pig5Fw:Pig15Rv	AAGCTCGAAAGTGCGGGTATCG	CTTGGCTGGTTCAGACTTACGT
Pig5Fw:Pig16Rv	AAGCTCGAAAGTGCGGGTATCG	AAGCTGCCTTCGCAATCGGAGT
Pig5Fw:Pig17Rv	AAGCTCGAAAGTGCGGGTATCG	CTGCCTTCGCAATCGGAGTTCT
Pig5Fw:Pig18Rv	AAGCTCGAAAGTGCGGGTATCG	ATCGGAGTTCTTCGTGATATCT
Pig5Fw:Pig19Rv	AAGCTCGAAAGTGCGGGTATCG	CTTCCGTATTACCGCGGCTGCT
Pig5Fw:Pig20Rv	AAGCTCGAAAGTGCGGGTATCG	TCATCCTGCACGCTACTTGGCT
Pig5Fw:Pig21Rv	AAGCTCGAAAGTGCGGGTATCG	GACCTTCCGTATTACCGCGGCT
Pig5Fw:Pig22Rv	AAGCTCGAAAGTGCGGGTATCG	GATATCTAAGCATTTCACCGCT
Pig5Fw:Pig23Rv	AAGCTCGAAAGTGCGGGTATCG	CCGCGGCATTTCACAACACGCT
Pig5Fw:Pig24Rv	AAGCTCGAAAGTGCGGGTATCG	TGGCACGGAATTAGCCGGTCCT
Pig5Fw:Pig25Rv	AAGCTCGAAAGTGCGGGTATCG	CAACCCATAGGGCCGTCATCCT
Pig5Fw:Pig26Rv	AAGCTCGAAAGTGCGGGTATCG	CGCTACACCACGAATTCCGCCT
Pig5Fw:Pig27Rv	AAGCTCGAAAGTGCGGGTATCG	GGTCCTTATTCATGCGGTACCT
Pig5Fw:Pig28Rv	AAGCTCGAAAGTGCGGGTATCG	ACACCACGAATTCCGCCTACCT
Pig5Fw:Pig29Rv	AAGCTCGAAAGTGCGGGTATCG	CGCTACTTGGCTGGTTCAGACT
Pig5Fw:Pig30Rv	AAGCTCGAAAGTGCGGGTATCG	CACGGAATTAGCCGGTCCTTAT
Pig5Fw:Pig31Rv	AAGCTCGAAAGTGCGGGTATCG	CAATCGGAGTTCTTCGTGATAT
Pig5Fw:Pig32Rv	AAGCTCGAAAGTGCGGGTATCG	CGCAATCGGAGTTCTTCGTGAT
Pig5Fw:Pig33Rv	AAGCTCGAAAGTGCGGGTATCG	TTACAACCCATAGGGCCGTCAT
Pig5Fw:Pig34Rv	AAGCTCGAAAGTGCGGGTATCG	GCTGGTTCAGACTTACGTCCAT
Pig5Fw:Pig35Rv	AAGCTCGAAAGTGCGGGTATCG	TACGGTAAGCTGCCTTCGCAAT
Pig5Fw:Pig36Rv	AAGCTCGAAAGTGCGGGTATCG	CTACGCTCCCTTTAAACCCAAT
Pig5Fw:Pig37Rv	AAGCTCGAAAGTGCGGGTATCG	CCGTCATCCTGCACGCTACTTG
Pig5Fw:Pig38Rv	AAGCTCGAAAGTGCGGGTATCG	TGGTTCAGACTTACGTCCATTG
Pig5Fw:Pig39Rv	AAGCTCGAAAGTGCGGGTATCG	TTCCGTATTACCGCGGCTGCTG
Pig5Fw:Pig40Rv	AAGCTCGAAAGTGCGGGTATCG	CATCCTGCACGCTACTTGGCTG
Pig5Fw:Pig41Rv	AAGCTCGAAAGTGCGGGTATCG	ACCTTCCGTATTACCGCGGCTG
Pig5Fw:Pig42Rv	AAGCTCGAAAGTGCGGGTATCG	AACCCATAGGGCCGTCATCCTG
Pig5Fw:Pig43Rv	AAGCTCGAAAGTGCGGGTATCG	GTCCTTATTCATGCGGTACCTG
Pig5Fw:Pig44Rv	AAGCTCGAAAGTGCGGGTATCG	AATTAGCCGGTCCTTATTCATG
Pig5Fw:Pig45Rv	AAGCTCGAAAGTGCGGGTATCG	CGTCATCCTGCACGCTACTTGG
Pig5Fw:Pig46Rv	AAGCTCGAAAGTGCGGGTATCG	ATCCTGCACGCTACTTGGCTGG
Pig5Fw:Pig47Rv	AAGCTCGAAAGTGCGGGTATCG	AAGCAGTTTACAACCCATAGGG
Pig5Fw:Pig48Rv	AAGCTCGAAAGTGCGGGTATCG	GGTAAGCTGCCTTCGCAATCGG
Pig5Fw:Pig49Rv	AAGCTCGAAAGTGCGGGTATCG	TAGCCGGTCCTTATTCATGCGG
Pig5Fw:Pig50Rv	AAGCTCGAAAGTGCGGGTATCG	AAAGCAGTTTACAACCCATAGG
Pig5Fw:Pig51Rv	AAGCTCGAAAGTGCGGGTATCG	ACGCTACGGTAAGCTGCCTTCG
Pig5Fw:Pig52Rv	AAGCTCGAAAGTGCGGGTATCG	CGGTAAGCTGCCTTCGCAATCG
Pig5Fw:Pig53Rv	AAGCTCGAAAGTGCGGGTATCG	TTAGCCGGTCCTTATTCATGCG
Pig5Fw:Pig54Rv	AAGCTCGAAAGTGCGGGTATCG	CAGTTTACAACCCATAGGGCCG
Pig5Fw:Pig55Rv	AAGCTCGAAAGTGCGGGTATCG	TAAGCTGCCTTCGCAATCGGAG
Pig5Fw:Pig56Rv	AAGCTCGAAAGTGCGGGTATCG	GCACGCTACTTGGCTGGTTCAG
Pig5Fw:Pig57Rv	AAGCTCGAAAGTGCGGGTATCG	TACCCGCACTTTCGAGCTTCAG
Pig5Fw:Pig58Rv	AAGCTCGAAAGTGCGGGTATCG	GGAGTTCTTCGTGATATCTAAG
Pig5Fw:Pig59Rv	AAGCTCGAAAGTGCGGGTATCG	CTGCACGCTACTTGGCTGGTTC
Pig5Fw:Pig60Rv	AAGCTCGAAAGTGCGGGTATCG	GCTGCCTTCGCAATCGGAGTTC
Pig5Fw:Pig61Rv	AAGCTCGAAAGTGCGGGTATCG	GATACCCGCACTTTCGAGCTTC
Pig5Fw:Pig62Rv	AAGCTCGAAAGTGCGGGTATCG	AACGCTACGGTAAGCTGCCTTC
Pig5Fw:Pig63Rv	AAGCTCGAAAGTGCGGGTATCG	CGCACTTTCGAGCTTCAGCGTC
Pig5Fw:Pig64Rv	AAGCTCGAAAGTGCGGGTATCG	GTTTACAACCCATAGGGCCGTC
Pig5Fw:Pig65Rv	AAGCTCGAAAGTGCGGGTATCG	TTGGCTGGTTCAGACTTACGTC
Pig5Fw:Pig66Rv	AAGCTCGAAAGTGCGGGTATCG	CACCACGAATTCCGCCTACCTC
Pig5Fw:Pig67Rv	AAGCTCGAAAGTGCGGGTATCG	AATCGGAGTTCTTCGTGATATC
Pig5Fw:Pig68Rv	AAGCTCGAAAGTGCGGGTATCG	TACAACCCATAGGGCCGTCATC
Pig5Fw:Pig69Rv	AAGCTCGAAAGTGCGGGTATCG	ACGGTAAGCTGCCTTCGCAATC
Pig5Fw:Pig70Rv	AAGCTCGAAAGTGCGGGTATCG	TCCTTATTCATGCGGTACCTGC
Pig5Fw:Pig71Rv	AAGCTCGAAAGTGCGGGTATCG	ATTAGCCGGTCCTTATTCATGC
Pig5Fw:Pig72Rv	AAGCTCGAAAGTGCGGGTATCG	GTCATCCTGCACGCTACTTGGC
Pig5Fw:Pig73Rv	AAGCTCGAAAGTGCGGGTATCG	AGCAGTTTACAACCCATAGGGC
Pig5Fw:Pig74Rv	AAGCTCGAAAGTGCGGGTATCG	TGATATCTAAGCATTTCACCGC
Pig5Fw:Pig75Rv	AAGCTCGAAAGTGCGGGTATCG	ACCCGCACTTTCGAGCTTCAGC
Pig5Fw:Pig76Rv	AAGCTCGAAAGTGCGGGTATCG	GAGTTCTTCGTGATATCTAAGC
Pig5Fw:Pig77Rv	AAGCTCGAAAGTGCGGGTATCG	TGGCTGGTTCAGACTTACGTCC
Pig5Fw:Pig78Rv	AAGCTCGAAAGTGCGGGTATCG	ACCACGAATTCCGCCTACCTCC
Pig5Fw:Pig79Rv	AAGCTCGAAAGTGCGGGTATCG	ACAACCCATAGGGCCGTCATCC
Pig5Fw:Pig80Rv	AAGCTCGAAAGTGCGGGTATCG	GCAGTTTACAACCCATAGGGCC
Pig5Fw:Pig81Rv	AAGCTCGAAAGTGCGGGTATCG	GGCCTACGCTCCCTTTAAACCC
Pig5Fw:Pig82Rv	AAGCTCGAAAGTGCGGGTATCG	TACACCACGAATTCCGCCTACC
Pig5Fw:Pig83Rv	AAGCTCGAAAGTGCGGGTATCG	TTCAGACTTACGTCCATTGACC
Pig5Fw:Pig84Rv	AAGCTCGAAAGTGCGGGTATCG	CGGCCTACGCTCCCTTTAAACC
Pig5Fw:Pig85Rv	AAGCTCGAAAGTGCGGGTATCG	TATCTAAGCATTTCACCGCTAC
Pig5Fw:Pig86Rv	AAGCTCGAAAGTGCGGGTATCG	GTTCAGACTTACGTCCATTGAC
Pig5Fw:Pig87Rv	AAGCTCGAAAGTGCGGGTATCG	ACGCTACTTGGCTGGTTCAGAC
Pig5Fw:Pig88Rv	AAGCTCGAAAGTGCGGGTATCG	TCTAAGCATTTCACCGCTACAC
Pig5Fw:Pig89Rv	AAGCTCGAAAGTGCGGGTATCG	CCGGCCTACGCTCCCTTTAAAC
Pig5Fw:Pig90Rv	AAGCTCGAAAGTGCGGGTATCG	AAGCCGGCCTACGCTCCCTTTA
Pig5Fw:Pig91Rv	AAGCTCGAAAGTGCGGGTATCG	GCGGCATTTCACAACACGCTTA
Pig5Fw:Pig92Rv	AAGCTCGAAAGTGCGGGTATCG	GCACGGAATTAGCCGGTCCTTA
Pig5Fw:Pig93Rv	AAGCTCGAAAGTGCGGGTATCG	TCGGAGTTCTTCGTGATATCTA
Pig5Fw:Pig94Rv	AAGCTCGAAAGTGCGGGTATCG	GCTACACCACGAATTCCGCCTA
Pig5Fw:Pig95Rv	AAGCTCGAAAGTGCGGGTATCG	GCAATCGGAGTTCTTCGTGATA
Pig5Fw:Pig96Rv	AAGCTCGAAAGTGCGGGTATCG	TACGCTCCCTTTAAACCCAATA
Pig5Fw:Pig97Rv	AAGCTCGAAAGTGCGGGTATCG	GGTTCAGACTTACGTCCATTGA
Pig5Fw:Pig98Rv	AAGCTCGAAAGTGCGGGTATCG	TCGCAATCGGAGTTCTTCGTGA
Pig5Fw:Pig99Rv	AAGCTCGAAAGTGCGGGTATCG	GTAAGCTGCCTTCGCAATCGGA
Pig5Fw:Pig100Rv	AAGCTCGAAAGTGCGGGTATCG	CACGCTACTTGGCTGGTTCAGA
Pig5Fw:Pig101Rv	AAGCTCGAAAGTGCGGGTATCG	TGCACGCTACTTGGCTGGTTCA
Pig5Fw:Pig102Rv	AAGCTCGAAAGTGCGGGTATCG	ATACCCGCACTTTCGAGCTTCA
Pig5Fw:Pig103Rv	AAGCTCGAAAGTGCGGGTATCG	GCACTTTCGAGCTTCAGCGTCA
Pig5Fw:Pig104Rv	AAGCTCGAAAGTGCGGGTATCG	TTTACAACCCATAGGGCCGTCA
Pig5Fw:Pig105Rv	AAGCTCGAAAGTGCGGGTATCG	CCTTATTCATGCGGTACCTGCA
Pig5Fw:Pig106Rv	AAGCTCGAAAGTGCGGGTATCG	GCTACGGTAAGCTGCCTTCGCA
Pig5Fw:Pig107Rv	AAGCTCGAAAGTGCGGGTATCG	GGCTGGTTCAGACTTACGTCCA
Pig5Fw:Pig108Rv	AAGCTCGAAAGTGCGGGTATCG	GCCTACGCTCCCTTTAAACCCA
Pig5Fw:Pig109Rv	AAGCTCGAAAGTGCGGGTATCG	TCAGACTTACGTCCATTGACCA
Pig5Fw:Pig110Rv	AAGCTCGAAAGTGCGGGTATCG	ATCTAAGCATTTCACCGCTACA
Pig5Fw:Pig111Rv	AAGCTCGAAAGTGCGGGTATCG	AGCCGGCCTACGCTCCCTTTAA
Pig5Fw:Pig112Rv	AAGCTCGAAAGTGCGGGTATCG	CGGCATTTCACAACACGCTTAA
Pig5Fw:Pig113Rv	AAGCTCGAAAGTGCGGGTATCG	CGGAGTTCTTCGTGATATCTAA
Pig5Fw:Pig114Rv	AAGCTCGAAAGTGCGGGTATCG	ACGCTCCCTTTAAACCCAATAA
Pig5Fw:Pig115Rv	AAGCTCGAAAGTGCGGGTATCG	CTTATTCATGCGGTACCTGCAA
Pig5Fw:Pig116Rv	AAGCTCGAAAGTGCGGGTATCG	CTACGGTAAGCTGCCTTCGCAA
Pig5Fw:Pig117Rv	AAGCTCGAAAGTGCGGGTATCG	CCTACGCTCCCTTTAAACCCAA
Pig5Fw:Pig118Rv	AAGCTCGAAAGTGCGGGTATCG	CAGACTTACGTCCATTGACCAA
Pig5Fw:Pig119Rv	AAGCTCGAAAGTGCGGGTATCG	GCCGGCCTACGCTCCCTTTAAA
Pig5Fw:Pig120Rv	AAGCTCGAAAGTGCGGGTATCG	GGCATTTCACAACACGCTTAAA
Pig5Fw:Pig121Rv	AAGCTCGAAAGTGCGGGTATCG	TTATTCATGCGGTACCTGCAAA
Pig6Fw:Pig1Rv	AAGGACCGGCTAATTCCGTGCC	CCTGCACGCTACTTGGCTGGTT
Pig6Fw:Pig2Rv	AAGGACCGGCTAATTCCGTGCC	AGCTGCCTTCGCAATCGGAGTT
Pig6Fw:Pig3Rv	AAGGACCGGCTAATTCCGTGCC	TGCCTTCGCAATCGGAGTTCTT
Pig6Fw:Pig4Rv	AAGGACCGGCTAATTCCGTGCC	CGCGGCATTTCACAACACGCTT
Pig6Fw:Pig5Rv	AAGGACCGGCTAATTCCGTGCC	CGATACCCGCACTTTCGAGCTT
Pig6Fw:Pig6Rv	AAGGACCGGCTAATTCCGTGCC	GGCACGGAATTAGCCGGTCCTT
Pig6Fw:Pig7Rv	AAGGACCGGCTAATTCCGTGCC	TAACGCTACGGTAAGCTGCCTT
Pig6Fw:Pig8Rv	AAGGACCGGCTAATTCCGTGCC	GCCGTCATCCTGCACGCTACTT
Pig6Fw:Pig9Rv	AAGGACCGGCTAATTCCGTGCC	ACGGAATTAGCCGGTCCTTATT
Pig6Fw:Pig10Rv	AAGGACCGGCTAATTCCGTGCC	CTGGTTCAGACTTACGTCCATT
Pig6Fw:Pig11Rv	AAGGACCGGCTAATTCCGTGCC	TCCTGCACGCTACTTGGCTGGT
Pig6Fw:Pig12Rv	AAGGACCGGCTAATTCCGTGCC	TGCTGGCACGGAATTAGCCGGT
Pig6Fw:Pig13Rv	AAGGACCGGCTAATTCCGTGCC	CCGCACTTTCGAGCTTCAGCGT
Pig6Fw:Pig14Rv	AAGGACCGGCTAATTCCGTGCC	AGTTTACAACCCATAGGGCCGT
Pig6Fw:Pig15Rv	AAGGACCGGCTAATTCCGTGCC	CTTGGCTGGTTCAGACTTACGT
Pig6Fw:Pig16Rv	AAGGACCGGCTAATTCCGTGCC	AAGCTGCCTTCGCAATCGGAGT
Pig6Fw:Pig17Rv	AAGGACCGGCTAATTCCGTGCC	CTGCCTTCGCAATCGGAGTTCT
Pig6Fw:Pig18Rv	AAGGACCGGCTAATTCCGTGCC	ATCGGAGTTCTTCGTGATATCT
Pig6Fw:Pig19Rv	AAGGACCGGCTAATTCCGTGCC	CTTCCGTATTACCGCGGCTGCT
Pig6Fw:Pig20Rv	AAGGACCGGCTAATTCCGTGCC	TCATCCTGCACGCTACTTGGCT
Pig6Fw:Pig21Rv	AAGGACCGGCTAATTCCGTGCC	GACCTTCCGTATTACCGCGGCT
Pig6Fw:Pig22Rv	AAGGACCGGCTAATTCCGTGCC	GATATCTAAGCATTTCACCGCT
Pig6Fw:Pig23Rv	AAGGACCGGCTAATTCCGTGCC	CCGCGGCATTTCACAACACGCT
Pig6Fw:Pig24Rv	AAGGACCGGCTAATTCCGTGCC	TGGCACGGAATTAGCCGGTCCT
Pig6Fw:Pig25Rv	AAGGACCGGCTAATTCCGTGCC	CAACCCATAGGGCCGTCATCCT
Pig6Fw:Pig26Rv	AAGGACCGGCTAATTCCGTGCC	CGCTACACCACGAATTCCGCCT
Pig6Fw:Pig27Rv	AAGGACCGGCTAATTCCGTGCC	GGTCCTTATTCATGCGGTACCT
Pig6Fw:Pig28Rv	AAGGACCGGCTAATTCCGTGCC	ACACCACGAATTCCGCCTACCT
Pig6Fw:Pig29Rv	AAGGACCGGCTAATTCCGTGCC	CGCTACTTGGCTGGTTCAGACT
Pig6Fw:Pig30Rv	AAGGACCGGCTAATTCCGTGCC	CACGGAATTAGCCGGTCCTTAT
Pig6Fw:Pig31Rv	AAGGACCGGCTAATTCCGTGCC	CAATCGGAGTTCTTCGTGATAT
Pig6Fw:Pig32Rv	AAGGACCGGCTAATTCCGTGCC	CGCAATCGGAGTTCTTCGTGAT
Pig6Fw:Pig33Rv	AAGGACCGGCTAATTCCGTGCC	TTACAACCCATAGGGCCGTCAT
Pig6Fw:Pig34Rv	AAGGACCGGCTAATTCCGTGCC	GCTGGTTCAGACTTACGTCCAT
Pig6Fw:Pig35Rv	AAGGACCGGCTAATTCCGTGCC	TACGGTAAGCTGCCTTCGCAAT
Pig6Fw:Pig36Rv	AAGGACCGGCTAATTCCGTGCC	CTACGCTCCCTTTAAACCCAAT
Pig6Fw:Pig37Rv	AAGGACCGGCTAATTCCGTGCC	CCGTCATCCTGCACGCTACTTG
Pig6Fw:Pig38Rv	AAGGACCGGCTAATTCCGTGCC	TGGTTCAGACTTACGTCCATTG
Pig6Fw:Pig39Rv	AAGGACCGGCTAATTCCGTGCC	TTCCGTATTACCGCGGCTGCTG
Pig6Fw:Pig40Rv	AAGGACCGGCTAATTCCGTGCC	CATCCTGCACGCTACTTGGCTG
Pig6Fw:Pig41Rv	AAGGACCGGCTAATTCCGTGCC	ACCTTCCGTATTACCGCGGCTG
Pig6Fw:Pig42Rv	AAGGACCGGCTAATTCCGTGCC	AACCCATAGGGCCGTCATCCTG
Pig6Fw:Pig43Rv	AAGGACCGGCTAATTCCGTGCC	GTCCTTATTCATGCGGTACCTG
Pig6Fw:Pig44Rv	AAGGACCGGCTAATTCCGTGCC	AATTAGCCGGTCCTTATTCATG
Pig6Fw:Pig45Rv	AAGGACCGGCTAATTCCGTGCC	CGTCATCCTGCACGCTACTTGG
Pig6Fw:Pig46Rv	AAGGACCGGCTAATTCCGTGCC	ATCCTGCACGCTACTTGGCTGG
Pig6Fw:Pig47Rv	AAGGACCGGCTAATTCCGTGCC	AAGCAGTTTACAACCCATAGGG
Pig6Fw:Pig48Rv	AAGGACCGGCTAATTCCGTGCC	GGTAAGCTGCCTTCGCAATCGG
Pig6Fw:Pig49Rv	AAGGACCGGCTAATTCCGTGCC	TAGCCGGTCCTTATTCATGCGG
Pig6Fw:Pig50Rv	AAGGACCGGCTAATTCCGTGCC	AAAGCAGTTTACAACCCATAGG
Pig6Fw:Pig51Rv	AAGGACCGGCTAATTCCGTGCC	ACGCTACGGTAAGCTGCCTTCG
Pig6Fw:Pig52Rv	AAGGACCGGCTAATTCCGTGCC	CGGTAAGCTGCCTTCGCAATCG
Pig6Fw:Pig53Rv	AAGGACCGGCTAATTCCGTGCC	TTAGCCGGTCCTTATTCATGCG
Pig6Fw:Pig54Rv	AAGGACCGGCTAATTCCGTGCC	CAGTTTACAACCCATAGGGCCG
Pig6Fw:Pig55Rv	AAGGACCGGCTAATTCCGTGCC	TAAGCTGCCTTCGCAATCGGAG
Pig6Fw:Pig56Rv	AAGGACCGGCTAATTCCGTGCC	GCACGCTACTTGGCTGGTTCAG
Pig6Fw:Pig57Rv	AAGGACCGGCTAATTCCGTGCC	TACCCGCACTTTCGAGCTTCAG
Pig6Fw:Pig58Rv	AAGGACCGGCTAATTCCGTGCC	GGAGTTCTTCGTGATATCTAAG
Pig6Fw:Pig59Rv	AAGGACCGGCTAATTCCGTGCC	CTGCACGCTACTTGGCTGGTTC
Pig6Fw:Pig60Rv	AAGGACCGGCTAATTCCGTGCC	GCTGCCTTCGCAATCGGAGTTC
Pig6Fw:Pig61Rv	AAGGACCGGCTAATTCCGTGCC	GATACCCGCACTTTCGAGCTTC
Pig6Fw:Pig62Rv	AAGGACCGGCTAATTCCGTGCC	AACGCTACGGTAAGCTGCCTTC
Pig6Fw:Pig63Rv	AAGGACCGGCTAATTCCGTGCC	CGCACTTTCGAGCTTCAGCGTC
Pig6Fw:Pig64Rv	AAGGACCGGCTAATTCCGTGCC	GTTTACAACCCATAGGGCCGTC
Pig6Fw:Pig65Rv	AAGGACCGGCTAATTCCGTGCC	TTGGCTGGTTCAGACTTACGTC
Pig6Fw:Pig66Rv	AAGGACCGGCTAATTCCGTGCC	CACCACGAATTCCGCCTACCTC
Pig6Fw:Pig67Rv	AAGGACCGGCTAATTCCGTGCC	AATCGGAGTTCTTCGTGATATC
Pig6Fw:Pig68Rv	AAGGACCGGCTAATTCCGTGCC	TACAACCCATAGGGCCGTCATC
Pig6Fw:Pig69Rv	AAGGACCGGCTAATTCCGTGCC	ACGGTAAGCTGCCTTCGCAATC
Pig6Fw:Pig70Rv	AAGGACCGGCTAATTCCGTGCC	TCCTTATTCATGCGGTACCTGC
Pig6Fw:Pig71Rv	AAGGACCGGCTAATTCCGTGCC	ATTAGCCGGTCCTTATTCATGC
Pig6Fw:Pig72Rv	AAGGACCGGCTAATTCCGTGCC	GTCATCCTGCACGCTACTTGGC
Pig6Fw:Pig73Rv	AAGGACCGGCTAATTCCGTGCC	AGCAGTTTACAACCCATAGGGC
Pig6Fw:Pig74Rv	AAGGACCGGCTAATTCCGTGCC	TGATATCTAAGCATTTCACCGC
Pig6Fw:Pig75Rv	AAGGACCGGCTAATTCCGTGCC	ACCCGCACTTTCGAGCTTCAGC
Pig6Fw:Pig76Rv	AAGGACCGGCTAATTCCGTGCC	GAGTTCTTCGTGATATCTAAGC
Pig6Fw:Pig77Rv	AAGGACCGGCTAATTCCGTGCC	TGGCTGGTTCAGACTTACGTCC
Pig6Fw:Pig78Rv	AAGGACCGGCTAATTCCGTGCC	ACCACGAATTCCGCCTACCTCC
Pig6Fw:Pig79Rv	AAGGACCGGCTAATTCCGTGCC	ACAACCCATAGGGCCGTCATCC
Pig6Fw:Pig80Rv	AAGGACCGGCTAATTCCGTGCC	GCAGTTTACAACCCATAGGGCC
Pig6Fw:Pig81Rv	AAGGACCGGCTAATTCCGTGCC	GGCCTACGCTCCCTTTAAACCC
Pig6Fw:Pig82Rv	AAGGACCGGCTAATTCCGTGCC	TACACCACGAATTCCGCCTACC
Pig6Fw:Pig83Rv	AAGGACCGGCTAATTCCGTGCC	TTCAGACTTACGTCCATTGACC
Pig6Fw:Pig84Rv	AAGGACCGGCTAATTCCGTGCC	CGGCCTACGCTCCCTTTAAACC
Pig6Fw:Pig85Rv	AAGGACCGGCTAATTCCGTGCC	TATCTAAGCATTTCACCGCTAC
Pig6Fw:Pig86Rv	AAGGACCGGCTAATTCCGTGCC	GTTCAGACTTACGTCCATTGAC
Pig6Fw:Pig87Rv	AAGGACCGGCTAATTCCGTGCC	ACGCTACTTGGCTGGTTCAGAC
Pig6Fw:Pig88Rv	AAGGACCGGCTAATTCCGTGCC	TCTAAGCATTTCACCGCTACAC
Pig6Fw:Pig89Rv	AAGGACCGGCTAATTCCGTGCC	CCGGCCTACGCTCCCTTTAAAC
Pig6Fw:Pig90Rv	AAGGACCGGCTAATTCCGTGCC	AAGCCGGCCTACGCTCCCTTTA
Pig6Fw:Pig91Rv	AAGGACCGGCTAATTCCGTGCC	GCGGCATTTCACAACACGCTTA
Pig6Fw:Pig92Rv	AAGGACCGGCTAATTCCGTGCC	GCACGGAATTAGCCGGTCCTTA
Pig6Fw:Pig93Rv	AAGGACCGGCTAATTCCGTGCC	TCGGAGTTCTTCGTGATATCTA
Pig6Fw:Pig94Rv	AAGGACCGGCTAATTCCGTGCC	GCTACACCACGAATTCCGCCTA
Pig6Fw:Pig95Rv	AAGGACCGGCTAATTCCGTGCC	GCAATCGGAGTTCTTCGTGATA
Pig6Fw:Pig96Rv	AAGGACCGGCTAATTCCGTGCC	TACGCTCCCTTTAAACCCAATA
Pig6Fw:Pig97Rv	AAGGACCGGCTAATTCCGTGCC	GGTTCAGACTTACGTCCATTGA
Pig6Fw:Pig98Rv	AAGGACCGGCTAATTCCGTGCC	TCGCAATCGGAGTTCTTCGTGA
Pig6Fw:Pig99Rv	AAGGACCGGCTAATTCCGTGCC	GTAAGCTGCCTTCGCAATCGGA
Pig6Fw:Pig100Rv	AAGGACCGGCTAATTCCGTGCC	CACGCTACTTGGCTGGTTCAGA
Pig6Fw:Pig101Rv	AAGGACCGGCTAATTCCGTGCC	TGCACGCTACTTGGCTGGTTCA
Pig6Fw:Pig102Rv	AAGGACCGGCTAATTCCGTGCC	ATACCCGCACTTTCGAGCTTCA
Pig6Fw:Pig103Rv	AAGGACCGGCTAATTCCGTGCC	GCACTTTCGAGCTTCAGCGTCA
Pig6Fw:Pig104Rv	AAGGACCGGCTAATTCCGTGCC	TTTACAACCCATAGGGCCGTCA
Pig6Fw:Pig105Rv	AAGGACCGGCTAATTCCGTGCC	CCTTATTCATGCGGTACCTGCA
Pig6Fw:Pig106Rv	AAGGACCGGCTAATTCCGTGCC	GCTACGGTAAGCTGCCTTCGCA
Pig6Fw:Pig107Rv	AAGGACCGGCTAATTCCGTGCC	GGCTGGTTCAGACTTACGTCCA
Pig6Fw:Pig108Rv	AAGGACCGGCTAATTCCGTGCC	GCCTACGCTCCCTTTAAACCCA
Pig6Fw:Pig109Rv	AAGGACCGGCTAATTCCGTGCC	TCAGACTTACGTCCATTGACCA
Pig6Fw:Pig110Rv	AAGGACCGGCTAATTCCGTGCC	ATCTAAGCATTTCACCGCTACA
Pig6Fw:Pig111Rv	AAGGACCGGCTAATTCCGTGCC	AGCCGGCCTACGCTCCCTTTAA
Pig6Fw:Pig112Rv	AAGGACCGGCTAATTCCGTGCC	CGGCATTTCACAACACGCTTAA
Pig6Fw:Pig113Rv	AAGGACCGGCTAATTCCGTGCC	CGGAGTTCTTCGTGATATCTAA
Pig6Fw:Pig114Rv	AAGGACCGGCTAATTCCGTGCC	ACGCTCCCTTTAAACCCAATAA
Pig6Fw:Pig115Rv	AAGGACCGGCTAATTCCGTGCC	CTTATTCATGCGGTACCTGCAA
Pig6Fw:Pig116Rv	AAGGACCGGCTAATTCCGTGCC	CTACGGTAAGCTGCCTTCGCAA
Pig6Fw:Pig117Rv	AAGGACCGGCTAATTCCGTGCC	CCTACGCTCCCTTTAAACCCAA
Pig6Fw:Pig118Rv	AAGGACCGGCTAATTCCGTGCC	CAGACTTACGTCCATTGACCAA
Pig6Fw:Pig119Rv	AAGGACCGGCTAATTCCGTGCC	GCCGGCCTACGCTCCCTTTAAA
Pig6Fw:Pig120Rv	AAGGACCGGCTAATTCCGTGCC	GGCATTTCACAACACGCTTAAA
Pig6Fw:Pig121Rv	AAGGACCGGCTAATTCCGTGCC	TTATTCATGCGGTACCTGCAAA
Pig7Fw:Pig1Rv	AAGGCAGCTTACCGTAGCGTTA	CCTGCACGCTACTTGGCTGGTT
Pig7Fw:Pig2Rv	AAGGCAGCTTACCGTAGCGTTA	AGCTGCCTTCGCAATCGGAGTT
Pig7Fw:Pig3Rv	AAGGCAGCTTACCGTAGCGTTA	TGCCTTCGCAATCGGAGTTCTT
Pig7Fw:Pig4Rv	AAGGCAGCTTACCGTAGCGTTA	CGCGGCATTTCACAACACGCTT
Pig7Fw:Pig5Rv	AAGGCAGCTTACCGTAGCGTTA	CGATACCCGCACTTTCGAGCTT
Pig7Fw:Pig6Rv	AAGGCAGCTTACCGTAGCGTTA	GGCACGGAATTAGCCGGTCCTT
Pig7Fw:Pig7Rv	AAGGCAGCTTACCGTAGCGTTA	TAACGCTACGGTAAGCTGCCTT
Pig7Fw:Pig8Rv	AAGGCAGCTTACCGTAGCGTTA	GCCGTCATCCTGCACGCTACTT
Pig7Fw:Pig9Rv	AAGGCAGCTTACCGTAGCGTTA	ACGGAATTAGCCGGTCCTTATT
Pig7Fw:Pig10Rv	AAGGCAGCTTACCGTAGCGTTA	CTGGTTCAGACTTACGTCCATT
Pig7Fw:Pig11Rv	AAGGCAGCTTACCGTAGCGTTA	TCCTGCACGCTACTTGGCTGGT
Pig7Fw:Pig12Rv	AAGGCAGCTTACCGTAGCGTTA	TGCTGGCACGGAATTAGCCGGT
Pig7Fw:Pig13Rv	AAGGCAGCTTACCGTAGCGTTA	CCGCACTTTCGAGCTTCAGCGT
Pig7Fw:Pig14Rv	AAGGCAGCTTACCGTAGCGTTA	AGTTTACAACCCATAGGGCCGT
Pig7Fw:Pig15Rv	AAGGCAGCTTACCGTAGCGTTA	CTTGGCTGGTTCAGACTTACGT
Pig7Fw:Pig16Rv	AAGGCAGCTTACCGTAGCGTTA	AAGCTGCCTTCGCAATCGGAGT
Pig7Fw:Pig17Rv	AAGGCAGCTTACCGTAGCGTTA	CTGCCTTCGCAATCGGAGTTCT
Pig7Fw:Pig18Rv	AAGGCAGCTTACCGTAGCGTTA	ATCGGAGTTCTTCGTGATATCT
Pig7Fw:Pig19Rv	AAGGCAGCTTACCGTAGCGTTA	CTTCCGTATTACCGCGGCTGCT
Pig7Fw:Pig20Rv	AAGGCAGCTTACCGTAGCGTTA	TCATCCTGCACGCTACTTGGCT
Pig7Fw:Pig21Rv	AAGGCAGCTTACCGTAGCGTTA	GACCTTCCGTATTACCGCGGCT
Pig7Fw:Pig22Rv	AAGGCAGCTTACCGTAGCGTTA	GATATCTAAGCATTTCACCGCT
Pig7Fw:Pig23Rv	AAGGCAGCTTACCGTAGCGTTA	CCGCGGCATTTCACAACACGCT
Pig7Fw:Pig24Rv	AAGGCAGCTTACCGTAGCGTTA	TGGCACGGAATTAGCCGGTCCT
Pig7Fw:Pig25Rv	AAGGCAGCTTACCGTAGCGTTA	CAACCCATAGGGCCGTCATCCT
Pig7Fw:Pig26Rv	AAGGCAGCTTACCGTAGCGTTA	CGCTACACCACGAATTCCGCCT
Pig7Fw:Pig27Rv	AAGGCAGCTTACCGTAGCGTTA	GGTCCTTATTCATGCGGTACCT
Pig7Fw:Pig28Rv	AAGGCAGCTTACCGTAGCGTTA	ACACCACGAATTCCGCCTACCT
Pig7Fw:Pig29Rv	AAGGCAGCTTACCGTAGCGTTA	CGCTACTTGGCTGGTTCAGACT
Pig7Fw:Pig30Rv	AAGGCAGCTTACCGTAGCGTTA	CACGGAATTAGCCGGTCCTTAT
Pig7Fw:Pig31Rv	AAGGCAGCTTACCGTAGCGTTA	CAATCGGAGTTCTTCGTGATAT
Pig7Fw:Pig32Rv	AAGGCAGCTTACCGTAGCGTTA	CGCAATCGGAGTTCTTCGTGAT
Pig7Fw:Pig33Rv	AAGGCAGCTTACCGTAGCGTTA	TTACAACCCATAGGGCCGTCAT
Pig7Fw:Pig34Rv	AAGGCAGCTTACCGTAGCGTTA	GCTGGTTCAGACTTACGTCCAT
Pig7Fw:Pig35Rv	AAGGCAGCTTACCGTAGCGTTA	TACGGTAAGCTGCCTTCGCAAT
Pig7Fw:Pig36Rv	AAGGCAGCTTACCGTAGCGTTA	CTACGCTCCCTTTAAACCCAAT
Pig7Fw:Pig37Rv	AAGGCAGCTTACCGTAGCGTTA	CCGTCATCCTGCACGCTACTTG
Pig7Fw:Pig38Rv	AAGGCAGCTTACCGTAGCGTTA	TGGTTCAGACTTACGTCCATTG
Pig7Fw:Pig39Rv	AAGGCAGCTTACCGTAGCGTTA	TTCCGTATTACCGCGGCTGCTG
Pig7Fw:Pig40Rv	AAGGCAGCTTACCGTAGCGTTA	CATCCTGCACGCTACTTGGCTG
Pig7Fw:Pig41Rv	AAGGCAGCTTACCGTAGCGTTA	ACCTTCCGTATTACCGCGGCTG
Pig7Fw:Pig42Rv	AAGGCAGCTTACCGTAGCGTTA	AACCCATAGGGCCGTCATCCTG
Pig7Fw:Pig43Rv	AAGGCAGCTTACCGTAGCGTTA	GTCCTTATTCATGCGGTACCTG
Pig7Fw:Pig44Rv	AAGGCAGCTTACCGTAGCGTTA	AATTAGCCGGTCCTTATTCATG
Pig7Fw:Pig45Rv	AAGGCAGCTTACCGTAGCGTTA	CGTCATCCTGCACGCTACTTGG
Pig7Fw:Pig46Rv	AAGGCAGCTTACCGTAGCGTTA	ATCCTGCACGCTACTTGGCTGG
Pig7Fw:Pig47Rv	AAGGCAGCTTACCGTAGCGTTA	AAGCAGTTTACAACCCATAGGG
Pig7Fw:Pig48Rv	AAGGCAGCTTACCGTAGCGTTA	GGTAAGCTGCCTTCGCAATCGG
Pig7Fw:Pig49Rv	AAGGCAGCTTACCGTAGCGTTA	TAGCCGGTCCTTATTCATGCGG
Pig7Fw:Pig50Rv	AAGGCAGCTTACCGTAGCGTTA	AAAGCAGTTTACAACCCATAGG
Pig7Fw:Pig51Rv	AAGGCAGCTTACCGTAGCGTTA	ACGCTACGGTAAGCTGCCTTCG
Pig7Fw:Pig52Rv	AAGGCAGCTTACCGTAGCGTTA	CGGTAAGCTGCCTTCGCAATCG
Pig7Fw:Pig53Rv	AAGGCAGCTTACCGTAGCGTTA	TTAGCCGGTCCTTATTCATGCG
Pig7Fw:Pig54Rv	AAGGCAGCTTACCGTAGCGTTA	CAGTTTACAACCCATAGGGCCG
Pig7Fw:Pig55Rv	AAGGCAGCTTACCGTAGCGTTA	TAAGCTGCCTTCGCAATCGGAG
Pig7Fw:Pig56Rv	AAGGCAGCTTACCGTAGCGTTA	GCACGCTACTTGGCTGGTTCAG
Pig7Fw:Pig57Rv	AAGGCAGCTTACCGTAGCGTTA	TACCCGCACTTTCGAGCTTCAG
Pig7Fw:Pig58Rv	AAGGCAGCTTACCGTAGCGTTA	GGAGTTCTTCGTGATATCTAAG
Pig7Fw:Pig59Rv	AAGGCAGCTTACCGTAGCGTTA	CTGCACGCTACTTGGCTGGTTC
Pig7Fw:Pig60Rv	AAGGCAGCTTACCGTAGCGTTA	GCTGCCTTCGCAATCGGAGTTC
Pig7Fw:Pig61Rv	AAGGCAGCTTACCGTAGCGTTA	GATACCCGCACTTTCGAGCTTC
Pig7Fw:Pig62Rv	AAGGCAGCTTACCGTAGCGTTA	AACGCTACGGTAAGCTGCCTTC
Pig7Fw:Pig63Rv	AAGGCAGCTTACCGTAGCGTTA	CGCACTTTCGAGCTTCAGCGTC
Pig7Fw:Pig64Rv	AAGGCAGCTTACCGTAGCGTTA	GTTTACAACCCATAGGGCCGTC
Pig7Fw:Pig65Rv	AAGGCAGCTTACCGTAGCGTTA	TTGGCTGGTTCAGACTTACGTC
Pig7Fw:Pig66Rv	AAGGCAGCTTACCGTAGCGTTA	CACCACGAATTCCGCCTACCTC
Pig7Fw:Pig67Rv	AAGGCAGCTTACCGTAGCGTTA	AATCGGAGTTCTTCGTGATATC
Pig7Fw:Pig68Rv	AAGGCAGCTTACCGTAGCGTTA	TACAACCCATAGGGCCGTCATC
Pig7Fw:Pig69Rv	AAGGCAGCTTACCGTAGCGTTA	ACGGTAAGCTGCCTTCGCAATC
Pig7Fw:Pig70Rv	AAGGCAGCTTACCGTAGCGTTA	TCCTTATTCATGCGGTACCTGC
Pig7Fw:Pig71Rv	AAGGCAGCTTACCGTAGCGTTA	ATTAGCCGGTCCTTATTCATGC
Pig7Fw:Pig72Rv	AAGGCAGCTTACCGTAGCGTTA	GTCATCCTGCACGCTACTTGGC
Pig7Fw:Pig73Rv	AAGGCAGCTTACCGTAGCGTTA	AGCAGTTTACAACCCATAGGGC
Pig7Fw:Pig74Rv	AAGGCAGCTTACCGTAGCGTTA	TGATATCTAAGCATTTCACCGC
Pig7Fw:Pig75Rv	AAGGCAGCTTACCGTAGCGTTA	ACCCGCACTTTCGAGCTTCAGC
Pig7Fw:Pig76Rv	AAGGCAGCTTACCGTAGCGTTA	GAGTTCTTCGTGATATCTAAGC
Pig7Fw:Pig77Rv	AAGGCAGCTTACCGTAGCGTTA	TGGCTGGTTCAGACTTACGTCC
Pig7Fw:Pig78Rv	AAGGCAGCTTACCGTAGCGTTA	ACCACGAATTCCGCCTACCTCC
Pig7Fw:Pig79Rv	AAGGCAGCTTACCGTAGCGTTA	ACAACCCATAGGGCCGTCATCC
Pig7Fw:Pig80Rv	AAGGCAGCTTACCGTAGCGTTA	GCAGTTTACAACCCATAGGGCC
Pig7Fw:Pig81Rv	AAGGCAGCTTACCGTAGCGTTA	GGCCTACGCTCCCTTTAAACCC
Pig7Fw:Pig82Rv	AAGGCAGCTTACCGTAGCGTTA	TACACCACGAATTCCGCCTACC
Pig7Fw:Pig83Rv	AAGGCAGCTTACCGTAGCGTTA	TTCAGACTTACGTCCATTGACC
Pig7Fw:Pig84Rv	AAGGCAGCTTACCGTAGCGTTA	CGGCCTACGCTCCCTTTAAACC
Pig7Fw:Pig85Rv	AAGGCAGCTTACCGTAGCGTTA	TATCTAAGCATTTCACCGCTAC
Pig7Fw:Pig86Rv	AAGGCAGCTTACCGTAGCGTTA	GTTCAGACTTACGTCCATTGAC
Pig7Fw:Pig87Rv	AAGGCAGCTTACCGTAGCGTTA	ACGCTACTTGGCTGGTTCAGAC
Pig7Fw:Pig88Rv	AAGGCAGCTTACCGTAGCGTTA	TCTAAGCATTTCACCGCTACAC
Pig7Fw:Pig89Rv	AAGGCAGCTTACCGTAGCGTTA	CCGGCCTACGCTCCCTTTAAAC
Pig7Fw:Pig90Rv	AAGGCAGCTTACCGTAGCGTTA	AAGCCGGCCTACGCTCCCTTTA
Pig7Fw:Pig91Rv	AAGGCAGCTTACCGTAGCGTTA	GCGGCATTTCACAACACGCTTA
Pig7Fw:Pig92Rv	AAGGCAGCTTACCGTAGCGTTA	GCACGGAATTAGCCGGTCCTTA
Pig7Fw:Pig93Rv	AAGGCAGCTTACCGTAGCGTTA	TCGGAGTTCTTCGTGATATCTA
Pig7Fw:Pig94Rv	AAGGCAGCTTACCGTAGCGTTA	GCTACACCACGAATTCCGCCTA
Pig7Fw:Pig95Rv	AAGGCAGCTTACCGTAGCGTTA	GCAATCGGAGTTCTTCGTGATA
Pig7Fw:Pig96Rv	AAGGCAGCTTACCGTAGCGTTA	TACGCTCCCTTTAAACCCAATA
Pig7Fw:Pig97Rv	AAGGCAGCTTACCGTAGCGTTA	GGTTCAGACTTACGTCCATTGA
Pig7Fw:Pig98Rv	AAGGCAGCTTACCGTAGCGTTA	TCGCAATCGGAGTTCTTCGTGA
Pig7Fw:Pig99Rv	AAGGCAGCTTACCGTAGCGTTA	GTAAGCTGCCTTCGCAATCGGA
Pig7Fw:Pig100Rv	AAGGCAGCTTACCGTAGCGTTA	CACGCTACTTGGCTGGTTCAGA
Pig7Fw:Pig101Rv	AAGGCAGCTTACCGTAGCGTTA	TGCACGCTACTTGGCTGGTTCA
Pig7Fw:Pig102Rv	AAGGCAGCTTACCGTAGCGTTA	ATACCCGCACTTTCGAGCTTCA
Pig7Fw:Pig103Rv	AAGGCAGCTTACCGTAGCGTTA	GCACTTTCGAGCTTCAGCGTCA
Pig7Fw:Pig104Rv	AAGGCAGCTTACCGTAGCGTTA	TTTACAACCCATAGGGCCGTCA
Pig7Fw:Pig105Rv	AAGGCAGCTTACCGTAGCGTTA	CCTTATTCATGCGGTACCTGCA
Pig7Fw:Pig106Rv	AAGGCAGCTTACCGTAGCGTTA	GCTACGGTAAGCTGCCTTCGCA
Pig7Fw:Pig107Rv	AAGGCAGCTTACCGTAGCGTTA	GGCTGGTTCAGACTTACGTCCA
Pig7Fw:Pig108Rv	AAGGCAGCTTACCGTAGCGTTA	GCCTACGCTCCCTTTAAACCCA
Pig7Fw:Pig109Rv	AAGGCAGCTTACCGTAGCGTTA	TCAGACTTACGTCCATTGACCA
Pig7Fw:Pig110Rv	AAGGCAGCTTACCGTAGCGTTA	ATCTAAGCATTTCACCGCTACA
Pig7Fw:Pig111Rv	AAGGCAGCTTACCGTAGCGTTA	AGCCGGCCTACGCTCCCTTTAA
Pig7Fw:Pig112Rv	AAGGCAGCTTACCGTAGCGTTA	CGGCATTTCACAACACGCTTAA
Pig7Fw:Pig113Rv	AAGGCAGCTTACCGTAGCGTTA	CGGAGTTCTTCGTGATATCTAA
Pig7Fw:Pig114Rv	AAGGCAGCTTACCGTAGCGTTA	ACGCTCCCTTTAAACCCAATAA
Pig7Fw:Pig115Rv	AAGGCAGCTTACCGTAGCGTTA	CTTATTCATGCGGTACCTGCAA
Pig7Fw:Pig116Rv	AAGGCAGCTTACCGTAGCGTTA	CTACGGTAAGCTGCCTTCGCAA
Pig7Fw:Pig117Rv	AAGGCAGCTTACCGTAGCGTTA	CCTACGCTCCCTTTAAACCCAA
Pig7Fw:Pig118Rv	AAGGCAGCTTACCGTAGCGTTA	CAGACTTACGTCCATTGACCAA
Pig7Fw:Pig119Rv	AAGGCAGCTTACCGTAGCGTTA	GCCGGCCTACGCTCCCTTTAAA
Pig7Fw:Pig120Rv	AAGGCAGCTTACCGTAGCGTTA	GGCATTTCACAACACGCTTAAA
Pig7Fw:Pig121Rv	AAGGCAGCTTACCGTAGCGTTA	TTATTCATGCGGTACCTGCAAA
Pig8Fw:Pig1Rv	AAGTAGCGTGCAGGATGACGGC	CCTGCACGCTACTTGGCTGGTT
Pig8Fw:Pig2Rv	AAGTAGCGTGCAGGATGACGGC	AGCTGCCTTCGCAATCGGAGTT
Pig8Fw:Pig3Rv	AAGTAGCGTGCAGGATGACGGC	TGCCTTCGCAATCGGAGTTCTT
Pig8Fw:Pig4Rv	AAGTAGCGTGCAGGATGACGGC	CGCGGCATTTCACAACACGCTT
Pig8Fw:Pig5Rv	AAGTAGCGTGCAGGATGACGGC	CGATACCCGCACTTTCGAGCTT
Pig8Fw:Pig6Rv	AAGTAGCGTGCAGGATGACGGC	GGCACGGAATTAGCCGGTCCTT
Pig8Fw:Pig7Rv	AAGTAGCGTGCAGGATGACGGC	TAACGCTACGGTAAGCTGCCTT
Pig8Fw:Pig8Rv	AAGTAGCGTGCAGGATGACGGC	GCCGTCATCCTGCACGCTACTT
Pig8Fw:Pig9Rv	AAGTAGCGTGCAGGATGACGGC	ACGGAATTAGCCGGTCCTTATT
Pig8Fw:Pig10Rv	AAGTAGCGTGCAGGATGACGGC	CTGGTTCAGACTTACGTCCATT
Pig8Fw:Pig11Rv	AAGTAGCGTGCAGGATGACGGC	TCCTGCACGCTACTTGGCTGGT
Pig8Fw:Pig12Rv	AAGTAGCGTGCAGGATGACGGC	TGCTGGCACGGAATTAGCCGGT
Pig8Fw:Pig13Rv	AAGTAGCGTGCAGGATGACGGC	CCGCACTTTCGAGCTTCAGCGT
Pig8Fw:Pig14Rv	AAGTAGCGTGCAGGATGACGGC	AGTTTACAACCCATAGGGCCGT
Pig8Fw:Pig15Rv	AAGTAGCGTGCAGGATGACGGC	CTTGGCTGGTTCAGACTTACGT
Pig8Fw:Pig16Rv	AAGTAGCGTGCAGGATGACGGC	AAGCTGCCTTCGCAATCGGAGT
Pig8Fw:Pig17Rv	AAGTAGCGTGCAGGATGACGGC	CTGCCTTCGCAATCGGAGTTCT
Pig8Fw:Pig18Rv	AAGTAGCGTGCAGGATGACGGC	ATCGGAGTTCTTCGTGATATCT
Pig8Fw:Pig19Rv	AAGTAGCGTGCAGGATGACGGC	CTTCCGTATTACCGCGGCTGCT
Pig8Fw:Pig20Rv	AAGTAGCGTGCAGGATGACGGC	TCATCCTGCACGCTACTTGGCT
Pig8Fw:Pig21Rv	AAGTAGCGTGCAGGATGACGGC	GACCTTCCGTATTACCGCGGCT
Pig8Fw:Pig22Rv	AAGTAGCGTGCAGGATGACGGC	GATATCTAAGCATTTCACCGCT
Pig8Fw:Pig23Rv	AAGTAGCGTGCAGGATGACGGC	CCGCGGCATTTCACAACACGCT
Pig8Fw:Pig24Rv	AAGTAGCGTGCAGGATGACGGC	TGGCACGGAATTAGCCGGTCCT
Pig8Fw:Pig25Rv	AAGTAGCGTGCAGGATGACGGC	CAACCCATAGGGCCGTCATCCT
Pig8Fw:Pig26Rv	AAGTAGCGTGCAGGATGACGGC	CGCTACACCACGAATTCCGCCT
Pig8Fw:Pig27Rv	AAGTAGCGTGCAGGATGACGGC	GGTCCTTATTCATGCGGTACCT
Pig8Fw:Pig28Rv	AAGTAGCGTGCAGGATGACGGC	ACACCACGAATTCCGCCTACCT
Pig8Fw:Pig29Rv	AAGTAGCGTGCAGGATGACGGC	CGCTACTTGGCTGGTTCAGACT
Pig8Fw:Pig30Rv	AAGTAGCGTGCAGGATGACGGC	CACGGAATTAGCCGGTCCTTAT
Pig8Fw:Pig31Rv	AAGTAGCGTGCAGGATGACGGC	CAATCGGAGTTCTTCGTGATAT
Pig8Fw:Pig32Rv	AAGTAGCGTGCAGGATGACGGC	CGCAATCGGAGTTCTTCGTGAT
Pig8Fw:Pig33Rv	AAGTAGCGTGCAGGATGACGGC	TTACAACCCATAGGGCCGTCAT
Pig8Fw:Pig34Rv	AAGTAGCGTGCAGGATGACGGC	GCTGGTTCAGACTTACGTCCAT
Pig8Fw:Pig35Rv	AAGTAGCGTGCAGGATGACGGC	TACGGTAAGCTGCCTTCGCAAT
Pig8Fw:Pig36Rv	AAGTAGCGTGCAGGATGACGGC	CTACGCTCCCTTTAAACCCAAT
Pig8Fw:Pig37Rv	AAGTAGCGTGCAGGATGACGGC	CCGTCATCCTGCACGCTACTTG
Pig8Fw:Pig38Rv	AAGTAGCGTGCAGGATGACGGC	TGGTTCAGACTTACGTCCATTG
Pig8Fw:Pig39Rv	AAGTAGCGTGCAGGATGACGGC	TTCCGTATTACCGCGGCTGCTG
Pig8Fw:Pig40Rv	AAGTAGCGTGCAGGATGACGGC	CATCCTGCACGCTACTTGGCTG
Pig8Fw:Pig41Rv	AAGTAGCGTGCAGGATGACGGC	ACCTTCCGTATTACCGCGGCTG
Pig8Fw:Pig42Rv	AAGTAGCGTGCAGGATGACGGC	AACCCATAGGGCCGTCATCCTG
Pig8Fw:Pig43Rv	AAGTAGCGTGCAGGATGACGGC	GTCCTTATTCATGCGGTACCTG
Pig8Fw:Pig44Rv	AAGTAGCGTGCAGGATGACGGC	AATTAGCCGGTCCTTATTCATG
Pig8Fw:Pig45Rv	AAGTAGCGTGCAGGATGACGGC	CGTCATCCTGCACGCTACTTGG
Pig8Fw:Pig46Rv	AAGTAGCGTGCAGGATGACGGC	ATCCTGCACGCTACTTGGCTGG
Pig8Fw:Pig47Rv	AAGTAGCGTGCAGGATGACGGC	AAGCAGTTTACAACCCATAGGG
Pig8Fw:Pig48Rv	AAGTAGCGTGCAGGATGACGGC	GGTAAGCTGCCTTCGCAATCGG
Pig8Fw:Pig49Rv	AAGTAGCGTGCAGGATGACGGC	TAGCCGGTCCTTATTCATGCGG
Pig8Fw:Pig50Rv	AAGTAGCGTGCAGGATGACGGC	AAAGCAGTTTACAACCCATAGG
Pig8Fw:Pig51Rv	AAGTAGCGTGCAGGATGACGGC	ACGCTACGGTAAGCTGCCTTCG
Pig8Fw:Pig52Rv	AAGTAGCGTGCAGGATGACGGC	CGGTAAGCTGCCTTCGCAATCG
Pig8Fw:Pig53Rv	AAGTAGCGTGCAGGATGACGGC	TTAGCCGGTCCTTATTCATGCG
Pig8Fw:Pig54Rv	AAGTAGCGTGCAGGATGACGGC	CAGTTTACAACCCATAGGGCCG
Pig8Fw:Pig55Rv	AAGTAGCGTGCAGGATGACGGC	TAAGCTGCCTTCGCAATCGGAG
Pig8Fw:Pig56Rv	AAGTAGCGTGCAGGATGACGGC	GCACGCTACTTGGCTGGTTCAG
Pig8Fw:Pig57Rv	AAGTAGCGTGCAGGATGACGGC	TACCCGCACTTTCGAGCTTCAG
Pig8Fw:Pig58Rv	AAGTAGCGTGCAGGATGACGGC	GGAGTTCTTCGTGATATCTAAG
Pig8Fw:Pig59Rv	AAGTAGCGTGCAGGATGACGGC	CTGCACGCTACTTGGCTGGTTC
Pig8Fw:Pig60Rv	AAGTAGCGTGCAGGATGACGGC	GCTGCCTTCGCAATCGGAGTTC
Pig8Fw:Pig61Rv	AAGTAGCGTGCAGGATGACGGC	GATACCCGCACTTTCGAGCTTC
Pig8Fw:Pig62Rv	AAGTAGCGTGCAGGATGACGGC	AACGCTACGGTAAGCTGCCTTC
Pig8Fw:Pig63Rv	AAGTAGCGTGCAGGATGACGGC	CGCACTTTCGAGCTTCAGCGTC
Pig8Fw:Pig64Rv	AAGTAGCGTGCAGGATGACGGC	GTTTACAACCCATAGGGCCGTC
Pig8Fw:Pig65Rv	AAGTAGCGTGCAGGATGACGGC	TTGGCTGGTTCAGACTTACGTC
Pig8Fw:Pig66Rv	AAGTAGCGTGCAGGATGACGGC	CACCACGAATTCCGCCTACCTC
Pig8Fw:Pig67Rv	AAGTAGCGTGCAGGATGACGGC	AATCGGAGTTCTTCGTGATATC
Pig8Fw:Pig68Rv	AAGTAGCGTGCAGGATGACGGC	TACAACCCATAGGGCCGTCATC
Pig8Fw:Pig69Rv	AAGTAGCGTGCAGGATGACGGC	ACGGTAAGCTGCCTTCGCAATC
Pig8Fw:Pig70Rv	AAGTAGCGTGCAGGATGACGGC	TCCTTATTCATGCGGTACCTGC
Pig8Fw:Pig71Rv	AAGTAGCGTGCAGGATGACGGC	ATTAGCCGGTCCTTATTCATGC
Pig8Fw:Pig72Rv	AAGTAGCGTGCAGGATGACGGC	GTCATCCTGCACGCTACTTGGC
Pig8Fw:Pig73Rv	AAGTAGCGTGCAGGATGACGGC	AGCAGTTTACAACCCATAGGGC
Pig8Fw:Pig74Rv	AAGTAGCGTGCAGGATGACGGC	TGATATCTAAGCATTTCACCGC
Pig8Fw:Pig75Rv	AAGTAGCGTGCAGGATGACGGC	ACCCGCACTTTCGAGCTTCAGC
Pig8Fw:Pig76Rv	AAGTAGCGTGCAGGATGACGGC	GAGTTCTTCGTGATATCTAAGC
Pig8Fw:Pig77Rv	AAGTAGCGTGCAGGATGACGGC	TGGCTGGTTCAGACTTACGTCC
Pig8Fw:Pig78Rv	AAGTAGCGTGCAGGATGACGGC	ACCACGAATTCCGCCTACCTCC
Pig8Fw:Pig79Rv	AAGTAGCGTGCAGGATGACGGC	ACAACCCATAGGGCCGTCATCC
Pig8Fw:Pig80Rv	AAGTAGCGTGCAGGATGACGGC	GCAGTTTACAACCCATAGGGCC
Pig8Fw:Pig81Rv	AAGTAGCGTGCAGGATGACGGC	GGCCTACGCTCCCTTTAAACCC
Pig8Fw:Pig82Rv	AAGTAGCGTGCAGGATGACGGC	TACACCACGAATTCCGCCTACC
Pig8Fw:Pig83Rv	AAGTAGCGTGCAGGATGACGGC	TTCAGACTTACGTCCATTGACC
Pig8Fw:Pig84Rv	AAGTAGCGTGCAGGATGACGGC	CGGCCTACGCTCCCTTTAAACC
Pig8Fw:Pig85Rv	AAGTAGCGTGCAGGATGACGGC	TATCTAAGCATTTCACCGCTAC
Pig8Fw:Pig86Rv	AAGTAGCGTGCAGGATGACGGC	GTTCAGACTTACGTCCATTGAC
Pig8Fw:Pig87Rv	AAGTAGCGTGCAGGATGACGGC	ACGCTACTTGGCTGGTTCAGAC
Pig8Fw:Pig88Rv	AAGTAGCGTGCAGGATGACGGC	TCTAAGCATTTCACCGCTACAC
Pig8Fw:Pig89Rv	AAGTAGCGTGCAGGATGACGGC	CCGGCCTACGCTCCCTTTAAAC
Pig8Fw:Pig90Rv	AAGTAGCGTGCAGGATGACGGC	AAGCCGGCCTACGCTCCCTTTA
Pig8Fw:Pig91Rv	AAGTAGCGTGCAGGATGACGGC	GCGGCATTTCACAACACGCTTA
Pig8Fw:Pig92Rv	AAGTAGCGTGCAGGATGACGGC	GCACGGAATTAGCCGGTCCTTA
Pig8Fw:Pig93Rv	AAGTAGCGTGCAGGATGACGGC	TCGGAGTTCTTCGTGATATCTA
Pig8Fw:Pig94Rv	AAGTAGCGTGCAGGATGACGGC	GCTACACCACGAATTCCGCCTA
Pig8Fw:Pig95Rv	AAGTAGCGTGCAGGATGACGGC	GCAATCGGAGTTCTTCGTGATA
Pig8Fw:Pig96Rv	AAGTAGCGTGCAGGATGACGGC	TACGCTCCCTTTAAACCCAATA
Pig8Fw:Pig97Rv	AAGTAGCGTGCAGGATGACGGC	GGTTCAGACTTACGTCCATTGA
Pig8Fw:Pig98Rv	AAGTAGCGTGCAGGATGACGGC	TCGCAATCGGAGTTCTTCGTGA
Pig8Fw:Pig99Rv	AAGTAGCGTGCAGGATGACGGC	GTAAGCTGCCTTCGCAATCGGA
Pig8Fw:Pig100Rv	AAGTAGCGTGCAGGATGACGGC	CACGCTACTTGGCTGGTTCAGA
Pig8Fw:Pig101Rv	AAGTAGCGTGCAGGATGACGGC	TGCACGCTACTTGGCTGGTTCA
Pig8Fw:Pig102Rv	AAGTAGCGTGCAGGATGACGGC	ATACCCGCACTTTCGAGCTTCA
Pig8Fw:Pig103Rv	AAGTAGCGTGCAGGATGACGGC	GCACTTTCGAGCTTCAGCGTCA
Pig8Fw:Pig104Rv	AAGTAGCGTGCAGGATGACGGC	TTTACAACCCATAGGGCCGTCA
Pig8Fw:Pig105Rv	AAGTAGCGTGCAGGATGACGGC	CCTTATTCATGCGGTACCTGCA
Pig8Fw:Pig106Rv	AAGTAGCGTGCAGGATGACGGC	GCTACGGTAAGCTGCCTTCGCA
Pig8Fw:Pig107Rv	AAGTAGCGTGCAGGATGACGGC	GGCTGGTTCAGACTTACGTCCA
Pig8Fw:Pig108Rv	AAGTAGCGTGCAGGATGACGGC	GCCTACGCTCCCTTTAAACCCA
Pig8Fw:Pig109Rv	AAGTAGCGTGCAGGATGACGGC	TCAGACTTACGTCCATTGACCA
Pig8Fw:Pig110Rv	AAGTAGCGTGCAGGATGACGGC	ATCTAAGCATTTCACCGCTACA
Pig8Fw:Pig111Rv	AAGTAGCGTGCAGGATGACGGC	AGCCGGCCTACGCTCCCTTTAA
Pig8Fw:Pig112Rv	AAGTAGCGTGCAGGATGACGGC	CGGCATTTCACAACACGCTTAA
Pig8Fw:Pig113Rv	AAGTAGCGTGCAGGATGACGGC	CGGAGTTCTTCGTGATATCTAA
Pig8Fw:Pig114Rv	AAGTAGCGTGCAGGATGACGGC	ACGCTCCCTTTAAACCCAATAA
Pig8Fw:Pig115Rv	AAGTAGCGTGCAGGATGACGGC	CTTATTCATGCGGTACCTGCAA
Pig8Fw:Pig116Rv	AAGTAGCGTGCAGGATGACGGC	CTACGGTAAGCTGCCTTCGCAA
Pig8Fw:Pig117Rv	AAGTAGCGTGCAGGATGACGGC	CCTACGCTCCCTTTAAACCCAA
Pig8Fw:Pig118Rv	AAGTAGCGTGCAGGATGACGGC	CAGACTTACGTCCATTGACCAA
Pig8Fw:Pig119Rv	AAGTAGCGTGCAGGATGACGGC	GCCGGCCTACGCTCCCTTTAAA
Pig8Fw:Pig120Rv	AAGTAGCGTGCAGGATGACGGC	GGCATTTCACAACACGCTTAAA
Pig8Fw:Pig121Rv	AAGTAGCGTGCAGGATGACGGC	TTATTCATGCGGTACCTGCAAA
Pig9Fw:Pig1Rv	AATAAGGACCGGCTAATTCCGT	CCTGCACGCTACTTGGCTGGTT
Pig9Fw:Pig2Rv	AATAAGGACCGGCTAATTCCGT	AGCTGCCTTCGCAATCGGAGTT
Pig9Fw:Pig3Rv	AATAAGGACCGGCTAATTCCGT	TGCCTTCGCAATCGGAGTTCTT
Pig9Fw:Pig4Rv	AATAAGGACCGGCTAATTCCGT	CGCGGCATTTCACAACACGCTT
Pig9Fw:Pig5Rv	AATAAGGACCGGCTAATTCCGT	CGATACCCGCACTTTCGAGCTT
Pig9Fw:Pig6Rv	AATAAGGACCGGCTAATTCCGT	GGCACGGAATTAGCCGGTCCTT
Pig9Fw:Pig7Rv	AATAAGGACCGGCTAATTCCGT	TAACGCTACGGTAAGCTGCCTT
Pig9Fw:Pig8Rv	AATAAGGACCGGCTAATTCCGT	GCCGTCATCCTGCACGCTACTT
Pig9Fw:Pig9Rv	AATAAGGACCGGCTAATTCCGT	ACGGAATTAGCCGGTCCTTATT
Pig9Fw:Pig10Rv	AATAAGGACCGGCTAATTCCGT	CTGGTTCAGACTTACGTCCATT
Pig9Fw:Pig11Rv	AATAAGGACCGGCTAATTCCGT	TCCTGCACGCTACTTGGCTGGT
Pig9Fw:Pig12Rv	AATAAGGACCGGCTAATTCCGT	TGCTGGCACGGAATTAGCCGGT
Pig9Fw:Pig13Rv	AATAAGGACCGGCTAATTCCGT	CCGCACTTTCGAGCTTCAGCGT
Pig9Fw:Pig14Rv	AATAAGGACCGGCTAATTCCGT	AGTTTACAACCCATAGGGCCGT
Pig9Fw:Pig15Rv	AATAAGGACCGGCTAATTCCGT	CTTGGCTGGTTCAGACTTACGT
Pig9Fw:Pig16Rv	AATAAGGACCGGCTAATTCCGT	AAGCTGCCTTCGCAATCGGAGT
Pig9Fw:Pig17Rv	AATAAGGACCGGCTAATTCCGT	CTGCCTTCGCAATCGGAGTTCT
Pig9Fw:Pig18Rv	AATAAGGACCGGCTAATTCCGT	ATCGGAGTTCTTCGTGATATCT
Pig9Fw:Pig19Rv	AATAAGGACCGGCTAATTCCGT	CTTCCGTATTACCGCGGCTGCT
Pig9Fw:Pig20Rv	AATAAGGACCGGCTAATTCCGT	TCATCCTGCACGCTACTTGGCT
Pig9Fw:Pig21Rv	AATAAGGACCGGCTAATTCCGT	GACCTTCCGTATTACCGCGGCT
Pig9Fw:Pig22Rv	AATAAGGACCGGCTAATTCCGT	GATATCTAAGCATTTCACCGCT
Pig9Fw:Pig23Rv	AATAAGGACCGGCTAATTCCGT	CCGCGGCATTTCACAACACGCT
Pig9Fw:Pig24Rv	AATAAGGACCGGCTAATTCCGT	TGGCACGGAATTAGCCGGTCCT
Pig9Fw:Pig25Rv	AATAAGGACCGGCTAATTCCGT	CAACCCATAGGGCCGTCATCCT
Pig9Fw:Pig26Rv	AATAAGGACCGGCTAATTCCGT	CGCTACACCACGAATTCCGCCT
Pig9Fw:Pig27Rv	AATAAGGACCGGCTAATTCCGT	GGTCCTTATTCATGCGGTACCT
Pig9Fw:Pig28Rv	AATAAGGACCGGCTAATTCCGT	ACACCACGAATTCCGCCTACCT
Pig9Fw:Pig29Rv	AATAAGGACCGGCTAATTCCGT	CGCTACTTGGCTGGTTCAGACT
Pig9Fw:Pig30Rv	AATAAGGACCGGCTAATTCCGT	CACGGAATTAGCCGGTCCTTAT
Pig9Fw:Pig31Rv	AATAAGGACCGGCTAATTCCGT	CAATCGGAGTTCTTCGTGATAT
Pig9Fw:Pig32Rv	AATAAGGACCGGCTAATTCCGT	CGCAATCGGAGTTCTTCGTGAT
Pig9Fw:Pig33Rv	AATAAGGACCGGCTAATTCCGT	TTACAACCCATAGGGCCGTCAT
Pig9Fw:Pig34Rv	AATAAGGACCGGCTAATTCCGT	GCTGGTTCAGACTTACGTCCAT
Pig9Fw:Pig35Rv	AATAAGGACCGGCTAATTCCGT	TACGGTAAGCTGCCTTCGCAAT
Pig9Fw:Pig36Rv	AATAAGGACCGGCTAATTCCGT	CTACGCTCCCTTTAAACCCAAT
Pig9Fw:Pig37Rv	AATAAGGACCGGCTAATTCCGT	CCGTCATCCTGCACGCTACTTG
Pig9Fw:Pig38Rv	AATAAGGACCGGCTAATTCCGT	TGGTTCAGACTTACGTCCATTG
Pig9Fw:Pig39Rv	AATAAGGACCGGCTAATTCCGT	TTCCGTATTACCGCGGCTGCTG
Pig9Fw:Pig40Rv	AATAAGGACCGGCTAATTCCGT	CATCCTGCACGCTACTTGGCTG
Pig9Fw:Pig41Rv	AATAAGGACCGGCTAATTCCGT	ACCTTCCGTATTACCGCGGCTG
Pig9Fw:Pig42Rv	AATAAGGACCGGCTAATTCCGT	AACCCATAGGGCCGTCATCCTG
Pig9Fw:Pig43Rv	AATAAGGACCGGCTAATTCCGT	GTCCTTATTCATGCGGTACCTG
Pig9Fw:Pig44Rv	AATAAGGACCGGCTAATTCCGT	AATTAGCCGGTCCTTATTCATG
Pig9Fw:Pig45Rv	AATAAGGACCGGCTAATTCCGT	CGTCATCCTGCACGCTACTTGG
Pig9Fw:Pig46Rv	AATAAGGACCGGCTAATTCCGT	ATCCTGCACGCTACTTGGCTGG
Pig9Fw:Pig47Rv	AATAAGGACCGGCTAATTCCGT	AAGCAGTTTACAACCCATAGGG
Pig9Fw:Pig48Rv	AATAAGGACCGGCTAATTCCGT	GGTAAGCTGCCTTCGCAATCGG
Pig9Fw:Pig49Rv	AATAAGGACCGGCTAATTCCGT	TAGCCGGTCCTTATTCATGCGG
Pig9Fw:Pig50Rv	AATAAGGACCGGCTAATTCCGT	AAAGCAGTTTACAACCCATAGG
Pig9Fw:Pig51Rv	AATAAGGACCGGCTAATTCCGT	ACGCTACGGTAAGCTGCCTTCG
Pig9Fw:Pig52Rv	AATAAGGACCGGCTAATTCCGT	CGGTAAGCTGCCTTCGCAATCG
Pig9Fw:Pig53Rv	AATAAGGACCGGCTAATTCCGT	TTAGCCGGTCCTTATTCATGCG
Pig9Fw:Pig54Rv	AATAAGGACCGGCTAATTCCGT	CAGTTTACAACCCATAGGGCCG
Pig9Fw:Pig55Rv	AATAAGGACCGGCTAATTCCGT	TAAGCTGCCTTCGCAATCGGAG
Pig9Fw:Pig56Rv	AATAAGGACCGGCTAATTCCGT	GCACGCTACTTGGCTGGTTCAG
Pig9Fw:Pig57Rv	AATAAGGACCGGCTAATTCCGT	TACCCGCACTTTCGAGCTTCAG
Pig9Fw:Pig58Rv	AATAAGGACCGGCTAATTCCGT	GGAGTTCTTCGTGATATCTAAG
Pig9Fw:Pig59Rv	AATAAGGACCGGCTAATTCCGT	CTGCACGCTACTTGGCTGGTTC
Pig9Fw:Pig60Rv	AATAAGGACCGGCTAATTCCGT	GCTGCCTTCGCAATCGGAGTTC
Pig9Fw:Pig61Rv	AATAAGGACCGGCTAATTCCGT	GATACCCGCACTTTCGAGCTTC
Pig9Fw:Pig62Rv	AATAAGGACCGGCTAATTCCGT	AACGCTACGGTAAGCTGCCTTC
Pig9Fw:Pig63Rv	AATAAGGACCGGCTAATTCCGT	CGCACTTTCGAGCTTCAGCGTC
Pig9Fw:Pig64Rv	AATAAGGACCGGCTAATTCCGT	GTTTACAACCCATAGGGCCGTC
Pig9Fw:Pig65Rv	AATAAGGACCGGCTAATTCCGT	TTGGCTGGTTCAGACTTACGTC
Pig9Fw:Pig66Rv	AATAAGGACCGGCTAATTCCGT	CACCACGAATTCCGCCTACCTC
Pig9Fw:Pig67Rv	AATAAGGACCGGCTAATTCCGT	AATCGGAGTTCTTCGTGATATC
Pig9Fw:Pig68Rv	AATAAGGACCGGCTAATTCCGT	TACAACCCATAGGGCCGTCATC
Pig9Fw:Pig69Rv	AATAAGGACCGGCTAATTCCGT	ACGGTAAGCTGCCTTCGCAATC
Pig9Fw:Pig70Rv	AATAAGGACCGGCTAATTCCGT	TCCTTATTCATGCGGTACCTGC
Pig9Fw:Pig71Rv	AATAAGGACCGGCTAATTCCGT	ATTAGCCGGTCCTTATTCATGC
Pig9Fw:Pig72Rv	AATAAGGACCGGCTAATTCCGT	GTCATCCTGCACGCTACTTGGC
Pig9Fw:Pig73Rv	AATAAGGACCGGCTAATTCCGT	AGCAGTTTACAACCCATAGGGC
Pig9Fw:Pig74Rv	AATAAGGACCGGCTAATTCCGT	TGATATCTAAGCATTTCACCGC
Pig9Fw:Pig75Rv	AATAAGGACCGGCTAATTCCGT	ACCCGCACTTTCGAGCTTCAGC
Pig9Fw:Pig76Rv	AATAAGGACCGGCTAATTCCGT	GAGTTCTTCGTGATATCTAAGC
Pig9Fw:Pig77Rv	AATAAGGACCGGCTAATTCCGT	TGGCTGGTTCAGACTTACGTCC
Pig9Fw:Pig78Rv	AATAAGGACCGGCTAATTCCGT	ACCACGAATTCCGCCTACCTCC
Pig9Fw:Pig79Rv	AATAAGGACCGGCTAATTCCGT	ACAACCCATAGGGCCGTCATCC
Pig9Fw:Pig80Rv	AATAAGGACCGGCTAATTCCGT	GCAGTTTACAACCCATAGGGCC
Pig9Fw:Pig81Rv	AATAAGGACCGGCTAATTCCGT	GGCCTACGCTCCCTTTAAACCC
Pig9Fw:Pig82Rv	AATAAGGACCGGCTAATTCCGT	TACACCACGAATTCCGCCTACC
Pig9Fw:Pig83Rv	AATAAGGACCGGCTAATTCCGT	TTCAGACTTACGTCCATTGACC
Pig9Fw:Pig84Rv	AATAAGGACCGGCTAATTCCGT	CGGCCTACGCTCCCTTTAAACC
Pig9Fw:Pig85Rv	AATAAGGACCGGCTAATTCCGT	TATCTAAGCATTTCACCGCTAC
Pig9Fw:Pig86Rv	AATAAGGACCGGCTAATTCCGT	GTTCAGACTTACGTCCATTGAC
Pig9Fw:Pig87Rv	AATAAGGACCGGCTAATTCCGT	ACGCTACTTGGCTGGTTCAGAC
Pig9Fw:Pig88Rv	AATAAGGACCGGCTAATTCCGT	TCTAAGCATTTCACCGCTACAC
Pig9Fw:Pig89Rv	AATAAGGACCGGCTAATTCCGT	CCGGCCTACGCTCCCTTTAAAC
Pig9Fw:Pig90Rv	AATAAGGACCGGCTAATTCCGT	AAGCCGGCCTACGCTCCCTTTA
Pig9Fw:Pig91Rv	AATAAGGACCGGCTAATTCCGT	GCGGCATTTCACAACACGCTTA
Pig9Fw:Pig92Rv	AATAAGGACCGGCTAATTCCGT	GCACGGAATTAGCCGGTCCTTA
Pig9Fw:Pig93Rv	AATAAGGACCGGCTAATTCCGT	TCGGAGTTCTTCGTGATATCTA
Pig9Fw:Pig94Rv	AATAAGGACCGGCTAATTCCGT	GCTACACCACGAATTCCGCCTA
Pig9Fw:Pig95Rv	AATAAGGACCGGCTAATTCCGT	GCAATCGGAGTTCTTCGTGATA
Pig9Fw:Pig96Rv	AATAAGGACCGGCTAATTCCGT	TACGCTCCCTTTAAACCCAATA
Pig9Fw:Pig97Rv	AATAAGGACCGGCTAATTCCGT	GGTTCAGACTTACGTCCATTGA
Pig9Fw:Pig98Rv	AATAAGGACCGGCTAATTCCGT	TCGCAATCGGAGTTCTTCGTGA
Pig9Fw:Pig99Rv	AATAAGGACCGGCTAATTCCGT	GTAAGCTGCCTTCGCAATCGGA
Pig9Fw:Pig100Rv	AATAAGGACCGGCTAATTCCGT	CACGCTACTTGGCTGGTTCAGA
Pig9Fw:Pig101Rv	AATAAGGACCGGCTAATTCCGT	TGCACGCTACTTGGCTGGTTCA
Pig9Fw:Pig102Rv	AATAAGGACCGGCTAATTCCGT	ATACCCGCACTTTCGAGCTTCA
Pig9Fw:Pig103Rv	AATAAGGACCGGCTAATTCCGT	GCACTTTCGAGCTTCAGCGTCA
Pig9Fw:Pig104Rv	AATAAGGACCGGCTAATTCCGT	TTTACAACCCATAGGGCCGTCA
Pig9Fw:Pig105Rv	AATAAGGACCGGCTAATTCCGT	CCTTATTCATGCGGTACCTGCA
Pig9Fw:Pig106Rv	AATAAGGACCGGCTAATTCCGT	GCTACGGTAAGCTGCCTTCGCA
Pig9Fw:Pig107Rv	AATAAGGACCGGCTAATTCCGT	GGCTGGTTCAGACTTACGTCCA
Pig9Fw:Pig108Rv	AATAAGGACCGGCTAATTCCGT	GCCTACGCTCCCTTTAAACCCA
Pig9Fw:Pig109Rv	AATAAGGACCGGCTAATTCCGT	TCAGACTTACGTCCATTGACCA
Pig9Fw:Pig110Rv	AATAAGGACCGGCTAATTCCGT	ATCTAAGCATTTCACCGCTACA
Pig9Fw:Pig111Rv	AATAAGGACCGGCTAATTCCGT	AGCCGGCCTACGCTCCCTTTAA
Pig9Fw:Pig112Rv	AATAAGGACCGGCTAATTCCGT	CGGCATTTCACAACACGCTTAA
Pig9Fw:Pig113Rv	AATAAGGACCGGCTAATTCCGT	CGGAGTTCTTCGTGATATCTAA
Pig9Fw:Pig114Rv	AATAAGGACCGGCTAATTCCGT	ACGCTCCCTTTAAACCCAATAA
Pig9Fw:Pig115Rv	AATAAGGACCGGCTAATTCCGT	CTTATTCATGCGGTACCTGCAA
Pig9Fw:Pig116Rv	AATAAGGACCGGCTAATTCCGT	CTACGGTAAGCTGCCTTCGCAA
Pig9Fw:Pig117Rv	AATAAGGACCGGCTAATTCCGT	CCTACGCTCCCTTTAAACCCAA
Pig9Fw:Pig118Rv	AATAAGGACCGGCTAATTCCGT	CAGACTTACGTCCATTGACCAA
Pig9Fw:Pig119Rv	AATAAGGACCGGCTAATTCCGT	GCCGGCCTACGCTCCCTTTAAA
Pig9Fw:Pig120Rv	AATAAGGACCGGCTAATTCCGT	GGCATTTCACAACACGCTTAAA
Pig9Fw:Pig121Rv	AATAAGGACCGGCTAATTCCGT	TTATTCATGCGGTACCTGCAAA
Pig10Fw:Pig1Rv	AATGGACGTAAGTCTGAACCAG	CCTGCACGCTACTTGGCTGGTT
Pig10Fw:Pig2Rv	AATGGACGTAAGTCTGAACCAG	AGCTGCCTTCGCAATCGGAGTT
Pig10Fw:Pig3Rv	AATGGACGTAAGTCTGAACCAG	TGCCTTCGCAATCGGAGTTCTT
Pig10Fw:Pig4Rv	AATGGACGTAAGTCTGAACCAG	CGCGGCATTTCACAACACGCTT
Pig10Fw:Pig5Rv	AATGGACGTAAGTCTGAACCAG	CGATACCCGCACTTTCGAGCTT
Pig10Fw:Pig6Rv	AATGGACGTAAGTCTGAACCAG	GGCACGGAATTAGCCGGTCCTT
Pig10Fw:Pig7Rv	AATGGACGTAAGTCTGAACCAG	TAACGCTACGGTAAGCTGCCTT
Pig10Fw:Pig8Rv	AATGGACGTAAGTCTGAACCAG	GCCGTCATCCTGCACGCTACTT
Pig10Fw:Pig9Rv	AATGGACGTAAGTCTGAACCAG	ACGGAATTAGCCGGTCCTTATT
Pig10Fw:Pig10Rv	AATGGACGTAAGTCTGAACCAG	CTGGTTCAGACTTACGTCCATT
Pig10Fw:Pig11Rv	AATGGACGTAAGTCTGAACCAG	TCCTGCACGCTACTTGGCTGGT
Pig10Fw:Pig12Rv	AATGGACGTAAGTCTGAACCAG	TGCTGGCACGGAATTAGCCGGT
Pig10Fw:Pig13Rv	AATGGACGTAAGTCTGAACCAG	CCGCACTTTCGAGCTTCAGCGT
Pig10Fw:Pig14Rv	AATGGACGTAAGTCTGAACCAG	AGTTTACAACCCATAGGGCCGT
Pig10Fw:Pig15Rv	AATGGACGTAAGTCTGAACCAG	CTTGGCTGGTTCAGACTTACGT
Pig10Fw:Pig16Rv	AATGGACGTAAGTCTGAACCAG	AAGCTGCCTTCGCAATCGGAGT
Pig10Fw:Pig17Rv	AATGGACGTAAGTCTGAACCAG	CTGCCTTCGCAATCGGAGTTCT
Pig10Fw:Pig18Rv	AATGGACGTAAGTCTGAACCAG	ATCGGAGTTCTTCGTGATATCT
Pig10Fw:Pig19Rv	AATGGACGTAAGTCTGAACCAG	CTTCCGTATTACCGCGGCTGCT
Pig10Fw:Pig20Rv	AATGGACGTAAGTCTGAACCAG	TCATCCTGCACGCTACTTGGCT
Pig10Fw:Pig21Rv	AATGGACGTAAGTCTGAACCAG	GACCTTCCGTATTACCGCGGCT
Pig10Fw:Pig22Rv	AATGGACGTAAGTCTGAACCAG	GATATCTAAGCATTTCACCGCT
Pig10Fw:Pig23Rv	AATGGACGTAAGTCTGAACCAG	CCGCGGCATTTCACAACACGCT
Pig10Fw:Pig24Rv	AATGGACGTAAGTCTGAACCAG	TGGCACGGAATTAGCCGGTCCT
Pig10Fw:Pig25Rv	AATGGACGTAAGTCTGAACCAG	CAACCCATAGGGCCGTCATCCT
Pig10Fw:Pig26Rv	AATGGACGTAAGTCTGAACCAG	CGCTACACCACGAATTCCGCCT
Pig10Fw:Pig27Rv	AATGGACGTAAGTCTGAACCAG	GGTCCTTATTCATGCGGTACCT
Pig10Fw:Pig28Rv	AATGGACGTAAGTCTGAACCAG	ACACCACGAATTCCGCCTACCT
Pig10Fw:Pig29Rv	AATGGACGTAAGTCTGAACCAG	CGCTACTTGGCTGGTTCAGACT
Pig10Fw:Pig30Rv	AATGGACGTAAGTCTGAACCAG	CACGGAATTAGCCGGTCCTTAT
Pig10Fw:Pig31Rv	AATGGACGTAAGTCTGAACCAG	CAATCGGAGTTCTTCGTGATAT
Pig10Fw:Pig32Rv	AATGGACGTAAGTCTGAACCAG	CGCAATCGGAGTTCTTCGTGAT
Pig10Fw:Pig33Rv	AATGGACGTAAGTCTGAACCAG	TTACAACCCATAGGGCCGTCAT
Pig10Fw:Pig34Rv	AATGGACGTAAGTCTGAACCAG	GCTGGTTCAGACTTACGTCCAT
Pig10Fw:Pig35Rv	AATGGACGTAAGTCTGAACCAG	TACGGTAAGCTGCCTTCGCAAT
Pig10Fw:Pig36Rv	AATGGACGTAAGTCTGAACCAG	CTACGCTCCCTTTAAACCCAAT
Pig10Fw:Pig37Rv	AATGGACGTAAGTCTGAACCAG	CCGTCATCCTGCACGCTACTTG
Pig10Fw:Pig38Rv	AATGGACGTAAGTCTGAACCAG	TGGTTCAGACTTACGTCCATTG
Pig10Fw:Pig39Rv	AATGGACGTAAGTCTGAACCAG	TTCCGTATTACCGCGGCTGCTG
Pig10Fw:Pig40Rv	AATGGACGTAAGTCTGAACCAG	CATCCTGCACGCTACTTGGCTG
Pig10Fw:Pig41Rv	AATGGACGTAAGTCTGAACCAG	ACCTTCCGTATTACCGCGGCTG
Pig10Fw:Pig42Rv	AATGGACGTAAGTCTGAACCAG	AACCCATAGGGCCGTCATCCTG
Pig10Fw:Pig43Rv	AATGGACGTAAGTCTGAACCAG	GTCCTTATTCATGCGGTACCTG
Pig10Fw:Pig44Rv	AATGGACGTAAGTCTGAACCAG	AATTAGCCGGTCCTTATTCATG
Pig10Fw:Pig45Rv	AATGGACGTAAGTCTGAACCAG	CGTCATCCTGCACGCTACTTGG
Pig10Fw:Pig46Rv	AATGGACGTAAGTCTGAACCAG	ATCCTGCACGCTACTTGGCTGG
Pig10Fw:Pig47Rv	AATGGACGTAAGTCTGAACCAG	AAGCAGTTTACAACCCATAGGG
Pig10Fw:Pig48Rv	AATGGACGTAAGTCTGAACCAG	GGTAAGCTGCCTTCGCAATCGG
Pig10Fw:Pig49Rv	AATGGACGTAAGTCTGAACCAG	TAGCCGGTCCTTATTCATGCGG
Pig10Fw:Pig50Rv	AATGGACGTAAGTCTGAACCAG	AAAGCAGTTTACAACCCATAGG
Pig10Fw:Pig51Rv	AATGGACGTAAGTCTGAACCAG	ACGCTACGGTAAGCTGCCTTCG
Pig10Fw:Pig52Rv	AATGGACGTAAGTCTGAACCAG	CGGTAAGCTGCCTTCGCAATCG
Pig10Fw:Pig53Rv	AATGGACGTAAGTCTGAACCAG	TTAGCCGGTCCTTATTCATGCG
Pig10Fw:Pig54Rv	AATGGACGTAAGTCTGAACCAG	CAGTTTACAACCCATAGGGCCG
Pig10Fw:Pig55Rv	AATGGACGTAAGTCTGAACCAG	TAAGCTGCCTTCGCAATCGGAG
Pig10Fw:Pig56Rv	AATGGACGTAAGTCTGAACCAG	GCACGCTACTTGGCTGGTTCAG
Pig10Fw:Pig57Rv	AATGGACGTAAGTCTGAACCAG	TACCCGCACTTTCGAGCTTCAG
Pig10Fw:Pig58Rv	AATGGACGTAAGTCTGAACCAG	GGAGTTCTTCGTGATATCTAAG
Pig10Fw:Pig59Rv	AATGGACGTAAGTCTGAACCAG	CTGCACGCTACTTGGCTGGTTC
Pig10Fw:Pig60Rv	AATGGACGTAAGTCTGAACCAG	GCTGCCTTCGCAATCGGAGTTC
Pig10Fw:Pig61Rv	AATGGACGTAAGTCTGAACCAG	GATACCCGCACTTTCGAGCTTC
Pig10Fw:Pig62Rv	AATGGACGTAAGTCTGAACCAG	AACGCTACGGTAAGCTGCCTTC
Pig10Fw:Pig63Rv	AATGGACGTAAGTCTGAACCAG	CGCACTTTCGAGCTTCAGCGTC
Pig10Fw:Pig64Rv	AATGGACGTAAGTCTGAACCAG	GTTTACAACCCATAGGGCCGTC
Pig10Fw:Pig65Rv	AATGGACGTAAGTCTGAACCAG	TTGGCTGGTTCAGACTTACGTC
Pig10Fw:Pig66Rv	AATGGACGTAAGTCTGAACCAG	CACCACGAATTCCGCCTACCTC
Pig10Fw:Pig67Rv	AATGGACGTAAGTCTGAACCAG	AATCGGAGTTCTTCGTGATATC
Pig10Fw:Pig68Rv	AATGGACGTAAGTCTGAACCAG	TACAACCCATAGGGCCGTCATC
Pig10Fw:Pig69Rv	AATGGACGTAAGTCTGAACCAG	ACGGTAAGCTGCCTTCGCAATC
Pig10Fw:Pig70Rv	AATGGACGTAAGTCTGAACCAG	TCCTTATTCATGCGGTACCTGC
Pig10Fw:Pig71Rv	AATGGACGTAAGTCTGAACCAG	ATTAGCCGGTCCTTATTCATGC
Pig10Fw:Pig72Rv	AATGGACGTAAGTCTGAACCAG	GTCATCCTGCACGCTACTTGGC
Pig10Fw:Pig73Rv	AATGGACGTAAGTCTGAACCAG	AGCAGTTTACAACCCATAGGGC
Pig10Fw:Pig74Rv	AATGGACGTAAGTCTGAACCAG	TGATATCTAAGCATTTCACCGC
Pig10Fw:Pig75Rv	AATGGACGTAAGTCTGAACCAG	ACCCGCACTTTCGAGCTTCAGC
Pig10Fw:Pig76Rv	AATGGACGTAAGTCTGAACCAG	GAGTTCTTCGTGATATCTAAGC
Pig10Fw:Pig77Rv	AATGGACGTAAGTCTGAACCAG	TGGCTGGTTCAGACTTACGTCC
Pig10Fw:Pig78Rv	AATGGACGTAAGTCTGAACCAG	ACCACGAATTCCGCCTACCTCC
Pig10Fw:Pig79Rv	AATGGACGTAAGTCTGAACCAG	ACAACCCATAGGGCCGTCATCC
Pig10Fw:Pig80Rv	AATGGACGTAAGTCTGAACCAG	GCAGTTTACAACCCATAGGGCC
Pig10Fw:Pig81Rv	AATGGACGTAAGTCTGAACCAG	GGCCTACGCTCCCTTTAAACCC
Pig10Fw:Pig82Rv	AATGGACGTAAGTCTGAACCAG	TACACCACGAATTCCGCCTACC
Pig10Fw:Pig83Rv	AATGGACGTAAGTCTGAACCAG	TTCAGACTTACGTCCATTGACC
Pig10Fw:Pig84Rv	AATGGACGTAAGTCTGAACCAG	CGGCCTACGCTCCCTTTAAACC
Pig10Fw:Pig85Rv	AATGGACGTAAGTCTGAACCAG	TATCTAAGCATTTCACCGCTAC
Pig10Fw:Pig86Rv	AATGGACGTAAGTCTGAACCAG	GTTCAGACTTACGTCCATTGAC
Pig10Fw:Pig87Rv	AATGGACGTAAGTCTGAACCAG	ACGCTACTTGGCTGGTTCAGAC
Pig10Fw:Pig88Rv	AATGGACGTAAGTCTGAACCAG	TCTAAGCATTTCACCGCTACAC
Pig10Fw:Pig89Rv	AATGGACGTAAGTCTGAACCAG	CCGGCCTACGCTCCCTTTAAAC
Pig10Fw:Pig90Rv	AATGGACGTAAGTCTGAACCAG	AAGCCGGCCTACGCTCCCTTTA
Pig10Fw:Pig91Rv	AATGGACGTAAGTCTGAACCAG	GCGGCATTTCACAACACGCTTA
Pig10Fw:Pig92Rv	AATGGACGTAAGTCTGAACCAG	GCACGGAATTAGCCGGTCCTTA
Pig10Fw:Pig93Rv	AATGGACGTAAGTCTGAACCAG	TCGGAGTTCTTCGTGATATCTA
Pig10Fw:Pig94Rv	AATGGACGTAAGTCTGAACCAG	GCTACACCACGAATTCCGCCTA
Pig10Fw:Pig95Rv	AATGGACGTAAGTCTGAACCAG	GCAATCGGAGTTCTTCGTGATA
Pig10Fw:Pig96Rv	AATGGACGTAAGTCTGAACCAG	TACGCTCCCTTTAAACCCAATA
Pig10Fw:Pig97Rv	AATGGACGTAAGTCTGAACCAG	GGTTCAGACTTACGTCCATTGA
Pig10Fw:Pig98Rv	AATGGACGTAAGTCTGAACCAG	TCGCAATCGGAGTTCTTCGTGA
Pig10Fw:Pig99Rv	AATGGACGTAAGTCTGAACCAG	GTAAGCTGCCTTCGCAATCGGA
Pig10Fw:Pig100Rv	AATGGACGTAAGTCTGAACCAG	CACGCTACTTGGCTGGTTCAGA
Pig10Fw:Pig101Rv	AATGGACGTAAGTCTGAACCAG	TGCACGCTACTTGGCTGGTTCA
Pig10Fw:Pig102Rv	AATGGACGTAAGTCTGAACCAG	ATACCCGCACTTTCGAGCTTCA
Pig10Fw:Pig103Rv	AATGGACGTAAGTCTGAACCAG	GCACTTTCGAGCTTCAGCGTCA
Pig10Fw:Pig104Rv	AATGGACGTAAGTCTGAACCAG	TTTACAACCCATAGGGCCGTCA
Pig10Fw:Pig105Rv	AATGGACGTAAGTCTGAACCAG	CCTTATTCATGCGGTACCTGCA
Pig10Fw:Pig106Rv	AATGGACGTAAGTCTGAACCAG	GCTACGGTAAGCTGCCTTCGCA
Pig10Fw:Pig107Rv	AATGGACGTAAGTCTGAACCAG	GGCTGGTTCAGACTTACGTCCA
Pig10Fw:Pig108Rv	AATGGACGTAAGTCTGAACCAG	GCCTACGCTCCCTTTAAACCCA
Pig10Fw:Pig109Rv	AATGGACGTAAGTCTGAACCAG	TCAGACTTACGTCCATTGACCA
Pig10Fw:Pig110Rv	AATGGACGTAAGTCTGAACCAG	ATCTAAGCATTTCACCGCTACA
Pig10Fw:Pig111Rv	AATGGACGTAAGTCTGAACCAG	AGCCGGCCTACGCTCCCTTTAA
Pig10Fw:Pig112Rv	AATGGACGTAAGTCTGAACCAG	CGGCATTTCACAACACGCTTAA
Pig10Fw:Pig113Rv	AATGGACGTAAGTCTGAACCAG	CGGAGTTCTTCGTGATATCTAA
Pig10Fw:Pig114Rv	AATGGACGTAAGTCTGAACCAG	ACGCTCCCTTTAAACCCAATAA
Pig10Fw:Pig115Rv	AATGGACGTAAGTCTGAACCAG	CTTATTCATGCGGTACCTGCAA
Pig10Fw:Pig116Rv	AATGGACGTAAGTCTGAACCAG	CTACGGTAAGCTGCCTTCGCAA
Pig10Fw:Pig117Rv	AATGGACGTAAGTCTGAACCAG	CCTACGCTCCCTTTAAACCCAA
Pig10Fw:Pig118Rv	AATGGACGTAAGTCTGAACCAG	CAGACTTACGTCCATTGACCAA
Pig10Fw:Pig119Rv	AATGGACGTAAGTCTGAACCAG	GCCGGCCTACGCTCCCTTTAAA
Pig10Fw:Pig120Rv	AATGGACGTAAGTCTGAACCAG	GGCATTTCACAACACGCTTAAA
Pig10Fw:Pig121Rv	AATGGACGTAAGTCTGAACCAG	TTATTCATGCGGTACCTGCAAA
Pig11Fw:Pig1Rv	ACCAGCCAAGTAGCGTGCAGGA	CCTGCACGCTACTTGGCTGGTT
Pig11Fw:Pig2Rv	ACCAGCCAAGTAGCGTGCAGGA	AGCTGCCTTCGCAATCGGAGTT
Pig11Fw:Pig3Rv	ACCAGCCAAGTAGCGTGCAGGA	TGCCTTCGCAATCGGAGTTCTT
Pig11Fw:Pig4Rv	ACCAGCCAAGTAGCGTGCAGGA	CGCGGCATTTCACAACACGCTT
Pig11Fw:Pig5Rv	ACCAGCCAAGTAGCGTGCAGGA	CGATACCCGCACTTTCGAGCTT
Pig11Fw:Pig6Rv	ACCAGCCAAGTAGCGTGCAGGA	GGCACGGAATTAGCCGGTCCTT
Pig11Fw:Pig7Rv	ACCAGCCAAGTAGCGTGCAGGA	TAACGCTACGGTAAGCTGCCTT
Pig11Fw:Pig8Rv	ACCAGCCAAGTAGCGTGCAGGA	GCCGTCATCCTGCACGCTACTT
Pig11Fw:Pig9Rv	ACCAGCCAAGTAGCGTGCAGGA	ACGGAATTAGCCGGTCCTTATT
Pig11Fw:Pig10Rv	ACCAGCCAAGTAGCGTGCAGGA	CTGGTTCAGACTTACGTCCATT
Pig11Fw:Pig11Rv	ACCAGCCAAGTAGCGTGCAGGA	TCCTGCACGCTACTTGGCTGGT
Pig11Fw:Pig12Rv	ACCAGCCAAGTAGCGTGCAGGA	TGCTGGCACGGAATTAGCCGGT
Pig11Fw:Pig13Rv	ACCAGCCAAGTAGCGTGCAGGA	CCGCACTTTCGAGCTTCAGCGT
Pig11Fw:Pig14Rv	ACCAGCCAAGTAGCGTGCAGGA	AGTTTACAACCCATAGGGCCGT
Pig11Fw:Pig15Rv	ACCAGCCAAGTAGCGTGCAGGA	CTTGGCTGGTTCAGACTTACGT
Pig11Fw:Pig16Rv	ACCAGCCAAGTAGCGTGCAGGA	AAGCTGCCTTCGCAATCGGAGT
Pig11Fw:Pig17Rv	ACCAGCCAAGTAGCGTGCAGGA	CTGCCTTCGCAATCGGAGTTCT
Pig11Fw:Pig18Rv	ACCAGCCAAGTAGCGTGCAGGA	ATCGGAGTTCTTCGTGATATCT
Pig11Fw:Pig19Rv	ACCAGCCAAGTAGCGTGCAGGA	CTTCCGTATTACCGCGGCTGCT
Pig11Fw:Pig20Rv	ACCAGCCAAGTAGCGTGCAGGA	TCATCCTGCACGCTACTTGGCT
Pig11Fw:Pig21Rv	ACCAGCCAAGTAGCGTGCAGGA	GACCTTCCGTATTACCGCGGCT
Pig11Fw:Pig22Rv	ACCAGCCAAGTAGCGTGCAGGA	GATATCTAAGCATTTCACCGCT
Pig11Fw:Pig23Rv	ACCAGCCAAGTAGCGTGCAGGA	CCGCGGCATTTCACAACACGCT
Pig11Fw:Pig24Rv	ACCAGCCAAGTAGCGTGCAGGA	TGGCACGGAATTAGCCGGTCCT
Pig11Fw:Pig25Rv	ACCAGCCAAGTAGCGTGCAGGA	CAACCCATAGGGCCGTCATCCT
Pig11Fw:Pig26Rv	ACCAGCCAAGTAGCGTGCAGGA	CGCTACACCACGAATTCCGCCT
Pig11Fw:Pig27Rv	ACCAGCCAAGTAGCGTGCAGGA	GGTCCTTATTCATGCGGTACCT
Pig11Fw:Pig28Rv	ACCAGCCAAGTAGCGTGCAGGA	ACACCACGAATTCCGCCTACCT
Pig11Fw:Pig29Rv	ACCAGCCAAGTAGCGTGCAGGA	CGCTACTTGGCTGGTTCAGACT
Pig11Fw:Pig30Rv	ACCAGCCAAGTAGCGTGCAGGA	CACGGAATTAGCCGGTCCTTAT
Pig11Fw:Pig31Rv	ACCAGCCAAGTAGCGTGCAGGA	CAATCGGAGTTCTTCGTGATAT
Pig11Fw:Pig32Rv	ACCAGCCAAGTAGCGTGCAGGA	CGCAATCGGAGTTCTTCGTGAT
Pig11Fw:Pig33Rv	ACCAGCCAAGTAGCGTGCAGGA	TTACAACCCATAGGGCCGTCAT
Pig11Fw:Pig34Rv	ACCAGCCAAGTAGCGTGCAGGA	GCTGGTTCAGACTTACGTCCAT
Pig11Fw:Pig35Rv	ACCAGCCAAGTAGCGTGCAGGA	TACGGTAAGCTGCCTTCGCAAT
Pig11Fw:Pig36Rv	ACCAGCCAAGTAGCGTGCAGGA	CTACGCTCCCTTTAAACCCAAT
Pig11Fw:Pig37Rv	ACCAGCCAAGTAGCGTGCAGGA	CCGTCATCCTGCACGCTACTTG
Pig11Fw:Pig38Rv	ACCAGCCAAGTAGCGTGCAGGA	TGGTTCAGACTTACGTCCATTG
Pig11Fw:Pig39Rv	ACCAGCCAAGTAGCGTGCAGGA	TTCCGTATTACCGCGGCTGCTG
Pig11Fw:Pig40Rv	ACCAGCCAAGTAGCGTGCAGGA	CATCCTGCACGCTACTTGGCTG
Pig11Fw:Pig41Rv	ACCAGCCAAGTAGCGTGCAGGA	ACCTTCCGTATTACCGCGGCTG
Pig11Fw:Pig42Rv	ACCAGCCAAGTAGCGTGCAGGA	AACCCATAGGGCCGTCATCCTG
Pig11Fw:Pig43Rv	ACCAGCCAAGTAGCGTGCAGGA	GTCCTTATTCATGCGGTACCTG
Pig11Fw:Pig44Rv	ACCAGCCAAGTAGCGTGCAGGA	AATTAGCCGGTCCTTATTCATG
Pig11Fw:Pig45Rv	ACCAGCCAAGTAGCGTGCAGGA	CGTCATCCTGCACGCTACTTGG
Pig11Fw:Pig46Rv	ACCAGCCAAGTAGCGTGCAGGA	ATCCTGCACGCTACTTGGCTGG
Pig11Fw:Pig47Rv	ACCAGCCAAGTAGCGTGCAGGA	AAGCAGTTTACAACCCATAGGG
Pig11Fw:Pig48Rv	ACCAGCCAAGTAGCGTGCAGGA	GGTAAGCTGCCTTCGCAATCGG
Pig11Fw:Pig49Rv	ACCAGCCAAGTAGCGTGCAGGA	TAGCCGGTCCTTATTCATGCGG
Pig11Fw:Pig50Rv	ACCAGCCAAGTAGCGTGCAGGA	AAAGCAGTTTACAACCCATAGG
Pig11Fw:Pig51Rv	ACCAGCCAAGTAGCGTGCAGGA	ACGCTACGGTAAGCTGCCTTCG
Pig11Fw:Pig52Rv	ACCAGCCAAGTAGCGTGCAGGA	CGGTAAGCTGCCTTCGCAATCG
Pig11Fw:Pig53Rv	ACCAGCCAAGTAGCGTGCAGGA	TTAGCCGGTCCTTATTCATGCG
Pig11Fw:Pig54Rv	ACCAGCCAAGTAGCGTGCAGGA	CAGTTTACAACCCATAGGGCCG
Pig11Fw:Pig55Rv	ACCAGCCAAGTAGCGTGCAGGA	TAAGCTGCCTTCGCAATCGGAG
Pig11Fw:Pig56Rv	ACCAGCCAAGTAGCGTGCAGGA	GCACGCTACTTGGCTGGTTCAG
Pig11Fw:Pig57Rv	ACCAGCCAAGTAGCGTGCAGGA	TACCCGCACTTTCGAGCTTCAG
Pig11Fw:Pig58Rv	ACCAGCCAAGTAGCGTGCAGGA	GGAGTTCTTCGTGATATCTAAG
Pig11Fw:Pig59Rv	ACCAGCCAAGTAGCGTGCAGGA	CTGCACGCTACTTGGCTGGTTC
Pig11Fw:Pig60Rv	ACCAGCCAAGTAGCGTGCAGGA	GCTGCCTTCGCAATCGGAGTTC
Pig11Fw:Pig61Rv	ACCAGCCAAGTAGCGTGCAGGA	GATACCCGCACTTTCGAGCTTC
Pig11Fw:Pig62Rv	ACCAGCCAAGTAGCGTGCAGGA	AACGCTACGGTAAGCTGCCTTC
Pig11Fw:Pig63Rv	ACCAGCCAAGTAGCGTGCAGGA	CGCACTTTCGAGCTTCAGCGTC
Pig11Fw:Pig64Rv	ACCAGCCAAGTAGCGTGCAGGA	GTTTACAACCCATAGGGCCGTC
Pig11Fw:Pig65Rv	ACCAGCCAAGTAGCGTGCAGGA	TTGGCTGGTTCAGACTTACGTC
Pig11Fw:Pig66Rv	ACCAGCCAAGTAGCGTGCAGGA	CACCACGAATTCCGCCTACCTC
Pig11Fw:Pig67Rv	ACCAGCCAAGTAGCGTGCAGGA	AATCGGAGTTCTTCGTGATATC
Pig11Fw:Pig68Rv	ACCAGCCAAGTAGCGTGCAGGA	TACAACCCATAGGGCCGTCATC
Pig11Fw:Pig69Rv	ACCAGCCAAGTAGCGTGCAGGA	ACGGTAAGCTGCCTTCGCAATC
Pig11Fw:Pig70Rv	ACCAGCCAAGTAGCGTGCAGGA	TCCTTATTCATGCGGTACCTGC
Pig11Fw:Pig71Rv	ACCAGCCAAGTAGCGTGCAGGA	ATTAGCCGGTCCTTATTCATGC
Pig11Fw:Pig72Rv	ACCAGCCAAGTAGCGTGCAGGA	GTCATCCTGCACGCTACTTGGC
Pig11Fw:Pig73Rv	ACCAGCCAAGTAGCGTGCAGGA	AGCAGTTTACAACCCATAGGGC
Pig11Fw:Pig74Rv	ACCAGCCAAGTAGCGTGCAGGA	TGATATCTAAGCATTTCACCGC
Pig11Fw:Pig75Rv	ACCAGCCAAGTAGCGTGCAGGA	ACCCGCACTTTCGAGCTTCAGC
Pig11Fw:Pig76Rv	ACCAGCCAAGTAGCGTGCAGGA	GAGTTCTTCGTGATATCTAAGC
Pig11Fw:Pig77Rv	ACCAGCCAAGTAGCGTGCAGGA	TGGCTGGTTCAGACTTACGTCC
Pig11Fw:Pig78Rv	ACCAGCCAAGTAGCGTGCAGGA	ACCACGAATTCCGCCTACCTCC
Pig11Fw:Pig79Rv	ACCAGCCAAGTAGCGTGCAGGA	ACAACCCATAGGGCCGTCATCC
Pig11Fw:Pig80Rv	ACCAGCCAAGTAGCGTGCAGGA	GCAGTTTACAACCCATAGGGCC
Pig11Fw:Pig81Rv	ACCAGCCAAGTAGCGTGCAGGA	GGCCTACGCTCCCTTTAAACCC
Pig11Fw:Pig82Rv	ACCAGCCAAGTAGCGTGCAGGA	TACACCACGAATTCCGCCTACC
Pig11Fw:Pig83Rv	ACCAGCCAAGTAGCGTGCAGGA	TTCAGACTTACGTCCATTGACC
Pig11Fw:Pig84Rv	ACCAGCCAAGTAGCGTGCAGGA	CGGCCTACGCTCCCTTTAAACC
Pig11Fw:Pig85Rv	ACCAGCCAAGTAGCGTGCAGGA	TATCTAAGCATTTCACCGCTAC
Pig11Fw:Pig86Rv	ACCAGCCAAGTAGCGTGCAGGA	GTTCAGACTTACGTCCATTGAC
Pig11Fw:Pig87Rv	ACCAGCCAAGTAGCGTGCAGGA	ACGCTACTTGGCTGGTTCAGAC
Pig11Fw:Pig88Rv	ACCAGCCAAGTAGCGTGCAGGA	TCTAAGCATTTCACCGCTACAC
Pig11Fw:Pig89Rv	ACCAGCCAAGTAGCGTGCAGGA	CCGGCCTACGCTCCCTTTAAAC
Pig11Fw:Pig90Rv	ACCAGCCAAGTAGCGTGCAGGA	AAGCCGGCCTACGCTCCCTTTA
Pig11Fw:Pig91Rv	ACCAGCCAAGTAGCGTGCAGGA	GCGGCATTTCACAACACGCTTA
Pig11Fw:Pig92Rv	ACCAGCCAAGTAGCGTGCAGGA	GCACGGAATTAGCCGGTCCTTA
Pig11Fw:Pig93Rv	ACCAGCCAAGTAGCGTGCAGGA	TCGGAGTTCTTCGTGATATCTA
Pig11Fw:Pig94Rv	ACCAGCCAAGTAGCGTGCAGGA	GCTACACCACGAATTCCGCCTA
Pig11Fw:Pig95Rv	ACCAGCCAAGTAGCGTGCAGGA	GCAATCGGAGTTCTTCGTGATA
Pig11Fw:Pig96Rv	ACCAGCCAAGTAGCGTGCAGGA	TACGCTCCCTTTAAACCCAATA
Pig11Fw:Pig97Rv	ACCAGCCAAGTAGCGTGCAGGA	GGTTCAGACTTACGTCCATTGA
Pig11Fw:Pig98Rv	ACCAGCCAAGTAGCGTGCAGGA	TCGCAATCGGAGTTCTTCGTGA
Pig11Fw:Pig99Rv	ACCAGCCAAGTAGCGTGCAGGA	GTAAGCTGCCTTCGCAATCGGA
Pig11Fw:Pig100Rv	ACCAGCCAAGTAGCGTGCAGGA	CACGCTACTTGGCTGGTTCAGA
Pig11Fw:Pig101Rv	ACCAGCCAAGTAGCGTGCAGGA	TGCACGCTACTTGGCTGGTTCA
Pig11Fw:Pig102Rv	ACCAGCCAAGTAGCGTGCAGGA	ATACCCGCACTTTCGAGCTTCA
Pig11Fw:Pig103Rv	ACCAGCCAAGTAGCGTGCAGGA	GCACTTTCGAGCTTCAGCGTCA
Pig11Fw:Pig104Rv	ACCAGCCAAGTAGCGTGCAGGA	TTTACAACCCATAGGGCCGTCA
Pig11Fw:Pig105Rv	ACCAGCCAAGTAGCGTGCAGGA	CCTTATTCATGCGGTACCTGCA
Pig11Fw:Pig106Rv	ACCAGCCAAGTAGCGTGCAGGA	GCTACGGTAAGCTGCCTTCGCA
Pig11Fw:Pig107Rv	ACCAGCCAAGTAGCGTGCAGGA	GGCTGGTTCAGACTTACGTCCA
Pig11Fw:Pig108Rv	ACCAGCCAAGTAGCGTGCAGGA	GCCTACGCTCCCTTTAAACCCA
Pig11Fw:Pig109Rv	ACCAGCCAAGTAGCGTGCAGGA	TCAGACTTACGTCCATTGACCA
Pig11Fw:Pig110Rv	ACCAGCCAAGTAGCGTGCAGGA	ATCTAAGCATTTCACCGCTACA
Pig11Fw:Pig111Rv	ACCAGCCAAGTAGCGTGCAGGA	AGCCGGCCTACGCTCCCTTTAA
Pig11Fw:Pig112Rv	ACCAGCCAAGTAGCGTGCAGGA	CGGCATTTCACAACACGCTTAA
Pig11Fw:Pig113Rv	ACCAGCCAAGTAGCGTGCAGGA	CGGAGTTCTTCGTGATATCTAA
Pig11Fw:Pig114Rv	ACCAGCCAAGTAGCGTGCAGGA	ACGCTCCCTTTAAACCCAATAA
Pig11Fw:Pig115Rv	ACCAGCCAAGTAGCGTGCAGGA	CTTATTCATGCGGTACCTGCAA
Pig11Fw:Pig116Rv	ACCAGCCAAGTAGCGTGCAGGA	CTACGGTAAGCTGCCTTCGCAA
Pig11Fw:Pig117Rv	ACCAGCCAAGTAGCGTGCAGGA	CCTACGCTCCCTTTAAACCCAA
Pig11Fw:Pig118Rv	ACCAGCCAAGTAGCGTGCAGGA	CAGACTTACGTCCATTGACCAA
Pig11Fw:Pig119Rv	ACCAGCCAAGTAGCGTGCAGGA	GCCGGCCTACGCTCCCTTTAAA
Pig11Fw:Pig120Rv	ACCAGCCAAGTAGCGTGCAGGA	GGCATTTCACAACACGCTTAAA
Pig11Fw:Pig121Rv	ACCAGCCAAGTAGCGTGCAGGA	TTATTCATGCGGTACCTGCAAA
Pig12Fw:Pig1Rv	ACCGGCTAATTCCGTGCCAGCA	CCTGCACGCTACTTGGCTGGTT
Pig12Fw:Pig2Rv	ACCGGCTAATTCCGTGCCAGCA	AGCTGCCTTCGCAATCGGAGTT
Pig12Fw:Pig3Rv	ACCGGCTAATTCCGTGCCAGCA	TGCCTTCGCAATCGGAGTTCTT
Pig12Fw:Pig4Rv	ACCGGCTAATTCCGTGCCAGCA	CGCGGCATTTCACAACACGCTT
Pig12Fw:Pig5Rv	ACCGGCTAATTCCGTGCCAGCA	CGATACCCGCACTTTCGAGCTT
Pig12Fw:Pig6Rv	ACCGGCTAATTCCGTGCCAGCA	GGCACGGAATTAGCCGGTCCTT
Pig12Fw:Pig7Rv	ACCGGCTAATTCCGTGCCAGCA	TAACGCTACGGTAAGCTGCCTT
Pig12Fw:Pig8Rv	ACCGGCTAATTCCGTGCCAGCA	GCCGTCATCCTGCACGCTACTT
Pig12Fw:Pig9Rv	ACCGGCTAATTCCGTGCCAGCA	ACGGAATTAGCCGGTCCTTATT
Pig12Fw:Pig10Rv	ACCGGCTAATTCCGTGCCAGCA	CTGGTTCAGACTTACGTCCATT
Pig12Fw:Pig11Rv	ACCGGCTAATTCCGTGCCAGCA	TCCTGCACGCTACTTGGCTGGT
Pig12Fw:Pig12Rv	ACCGGCTAATTCCGTGCCAGCA	TGCTGGCACGGAATTAGCCGGT
Pig12Fw:Pig13Rv	ACCGGCTAATTCCGTGCCAGCA	CCGCACTTTCGAGCTTCAGCGT
Pig12Fw:Pig14Rv	ACCGGCTAATTCCGTGCCAGCA	AGTTTACAACCCATAGGGCCGT
Pig12Fw:Pig15Rv	ACCGGCTAATTCCGTGCCAGCA	CTTGGCTGGTTCAGACTTACGT
Pig12Fw:Pig16Rv	ACCGGCTAATTCCGTGCCAGCA	AAGCTGCCTTCGCAATCGGAGT
Pig12Fw:Pig17Rv	ACCGGCTAATTCCGTGCCAGCA	CTGCCTTCGCAATCGGAGTTCT
Pig12Fw:Pig18Rv	ACCGGCTAATTCCGTGCCAGCA	ATCGGAGTTCTTCGTGATATCT
Pig12Fw:Pig19Rv	ACCGGCTAATTCCGTGCCAGCA	CTTCCGTATTACCGCGGCTGCT
Pig12Fw:Pig20Rv	ACCGGCTAATTCCGTGCCAGCA	TCATCCTGCACGCTACTTGGCT
Pig12Fw:Pig21Rv	ACCGGCTAATTCCGTGCCAGCA	GACCTTCCGTATTACCGCGGCT
Pig12Fw:Pig22Rv	ACCGGCTAATTCCGTGCCAGCA	GATATCTAAGCATTTCACCGCT
Pig12Fw:Pig23Rv	ACCGGCTAATTCCGTGCCAGCA	CCGCGGCATTTCACAACACGCT
Pig12Fw:Pig24Rv	ACCGGCTAATTCCGTGCCAGCA	TGGCACGGAATTAGCCGGTCCT
Pig12Fw:Pig25Rv	ACCGGCTAATTCCGTGCCAGCA	CAACCCATAGGGCCGTCATCCT
Pig12Fw:Pig26Rv	ACCGGCTAATTCCGTGCCAGCA	CGCTACACCACGAATTCCGCCT
Pig12Fw:Pig27Rv	ACCGGCTAATTCCGTGCCAGCA	GGTCCTTATTCATGCGGTACCT
Pig12Fw:Pig28Rv	ACCGGCTAATTCCGTGCCAGCA	ACACCACGAATTCCGCCTACCT
Pig12Fw:Pig29Rv	ACCGGCTAATTCCGTGCCAGCA	CGCTACTTGGCTGGTTCAGACT
Pig12Fw:Pig30Rv	ACCGGCTAATTCCGTGCCAGCA	CACGGAATTAGCCGGTCCTTAT
Pig12Fw:Pig31Rv	ACCGGCTAATTCCGTGCCAGCA	CAATCGGAGTTCTTCGTGATAT
Pig12Fw:Pig32Rv	ACCGGCTAATTCCGTGCCAGCA	CGCAATCGGAGTTCTTCGTGAT
Pig12Fw:Pig33Rv	ACCGGCTAATTCCGTGCCAGCA	TTACAACCCATAGGGCCGTCAT
Pig12Fw:Pig34Rv	ACCGGCTAATTCCGTGCCAGCA	GCTGGTTCAGACTTACGTCCAT
Pig12Fw:Pig35Rv	ACCGGCTAATTCCGTGCCAGCA	TACGGTAAGCTGCCTTCGCAAT
Pig12Fw:Pig36Rv	ACCGGCTAATTCCGTGCCAGCA	CTACGCTCCCTTTAAACCCAAT
Pig12Fw:Pig37Rv	ACCGGCTAATTCCGTGCCAGCA	CCGTCATCCTGCACGCTACTTG
Pig12Fw:Pig38Rv	ACCGGCTAATTCCGTGCCAGCA	TGGTTCAGACTTACGTCCATTG
Pig12Fw:Pig39Rv	ACCGGCTAATTCCGTGCCAGCA	TTCCGTATTACCGCGGCTGCTG
Pig12Fw:Pig40Rv	ACCGGCTAATTCCGTGCCAGCA	CATCCTGCACGCTACTTGGCTG
Pig12Fw:Pig41Rv	ACCGGCTAATTCCGTGCCAGCA	ACCTTCCGTATTACCGCGGCTG
Pig12Fw:Pig42Rv	ACCGGCTAATTCCGTGCCAGCA	AACCCATAGGGCCGTCATCCTG
Pig12Fw:Pig43Rv	ACCGGCTAATTCCGTGCCAGCA	GTCCTTATTCATGCGGTACCTG
Pig12Fw:Pig44Rv	ACCGGCTAATTCCGTGCCAGCA	AATTAGCCGGTCCTTATTCATG
Pig12Fw:Pig45Rv	ACCGGCTAATTCCGTGCCAGCA	CGTCATCCTGCACGCTACTTGG
Pig12Fw:Pig46Rv	ACCGGCTAATTCCGTGCCAGCA	ATCCTGCACGCTACTTGGCTGG
Pig12Fw:Pig47Rv	ACCGGCTAATTCCGTGCCAGCA	AAGCAGTTTACAACCCATAGGG
Pig12Fw:Pig48Rv	ACCGGCTAATTCCGTGCCAGCA	GGTAAGCTGCCTTCGCAATCGG
Pig12Fw:Pig49Rv	ACCGGCTAATTCCGTGCCAGCA	TAGCCGGTCCTTATTCATGCGG
Pig12Fw:Pig50Rv	ACCGGCTAATTCCGTGCCAGCA	AAAGCAGTTTACAACCCATAGG
Pig12Fw:Pig51Rv	ACCGGCTAATTCCGTGCCAGCA	ACGCTACGGTAAGCTGCCTTCG
Pig12Fw:Pig52Rv	ACCGGCTAATTCCGTGCCAGCA	CGGTAAGCTGCCTTCGCAATCG
Pig12Fw:Pig53Rv	ACCGGCTAATTCCGTGCCAGCA	TTAGCCGGTCCTTATTCATGCG
Pig12Fw:Pig54Rv	ACCGGCTAATTCCGTGCCAGCA	CAGTTTACAACCCATAGGGCCG
Pig12Fw:Pig55Rv	ACCGGCTAATTCCGTGCCAGCA	TAAGCTGCCTTCGCAATCGGAG
Pig12Fw:Pig56Rv	ACCGGCTAATTCCGTGCCAGCA	GCACGCTACTTGGCTGGTTCAG
Pig12Fw:Pig57Rv	ACCGGCTAATTCCGTGCCAGCA	TACCCGCACTTTCGAGCTTCAG
Pig12Fw:Pig58Rv	ACCGGCTAATTCCGTGCCAGCA	GGAGTTCTTCGTGATATCTAAG
Pig12Fw:Pig59Rv	ACCGGCTAATTCCGTGCCAGCA	CTGCACGCTACTTGGCTGGTTC
Pig12Fw:Pig60Rv	ACCGGCTAATTCCGTGCCAGCA	GCTGCCTTCGCAATCGGAGTTC
Pig12Fw:Pig61Rv	ACCGGCTAATTCCGTGCCAGCA	GATACCCGCACTTTCGAGCTTC
Pig12Fw:Pig62Rv	ACCGGCTAATTCCGTGCCAGCA	AACGCTACGGTAAGCTGCCTTC
Pig12Fw:Pig63Rv	ACCGGCTAATTCCGTGCCAGCA	CGCACTTTCGAGCTTCAGCGTC
Pig12Fw:Pig64Rv	ACCGGCTAATTCCGTGCCAGCA	GTTTACAACCCATAGGGCCGTC
Pig12Fw:Pig65Rv	ACCGGCTAATTCCGTGCCAGCA	TTGGCTGGTTCAGACTTACGTC
Pig12Fw:Pig66Rv	ACCGGCTAATTCCGTGCCAGCA	CACCACGAATTCCGCCTACCTC
Pig12Fw:Pig67Rv	ACCGGCTAATTCCGTGCCAGCA	AATCGGAGTTCTTCGTGATATC
Pig12Fw:Pig68Rv	ACCGGCTAATTCCGTGCCAGCA	TACAACCCATAGGGCCGTCATC
Pig12Fw:Pig69Rv	ACCGGCTAATTCCGTGCCAGCA	ACGGTAAGCTGCCTTCGCAATC
Pig12Fw:Pig70Rv	ACCGGCTAATTCCGTGCCAGCA	TCCTTATTCATGCGGTACCTGC
Pig12Fw:Pig71Rv	ACCGGCTAATTCCGTGCCAGCA	ATTAGCCGGTCCTTATTCATGC
Pig12Fw:Pig72Rv	ACCGGCTAATTCCGTGCCAGCA	GTCATCCTGCACGCTACTTGGC
Pig12Fw:Pig73Rv	ACCGGCTAATTCCGTGCCAGCA	AGCAGTTTACAACCCATAGGGC
Pig12Fw:Pig74Rv	ACCGGCTAATTCCGTGCCAGCA	TGATATCTAAGCATTTCACCGC
Pig12Fw:Pig75Rv	ACCGGCTAATTCCGTGCCAGCA	ACCCGCACTTTCGAGCTTCAGC
Pig12Fw:Pig76Rv	ACCGGCTAATTCCGTGCCAGCA	GAGTTCTTCGTGATATCTAAGC
Pig12Fw:Pig77Rv	ACCGGCTAATTCCGTGCCAGCA	TGGCTGGTTCAGACTTACGTCC
Pig12Fw:Pig78Rv	ACCGGCTAATTCCGTGCCAGCA	ACCACGAATTCCGCCTACCTCC
Pig12Fw:Pig79Rv	ACCGGCTAATTCCGTGCCAGCA	ACAACCCATAGGGCCGTCATCC
Pig12Fw:Pig80Rv	ACCGGCTAATTCCGTGCCAGCA	GCAGTTTACAACCCATAGGGCC
Pig12Fw:Pig81Rv	ACCGGCTAATTCCGTGCCAGCA	GGCCTACGCTCCCTTTAAACCC
Pig12Fw:Pig82Rv	ACCGGCTAATTCCGTGCCAGCA	TACACCACGAATTCCGCCTACC
Pig12Fw:Pig83Rv	ACCGGCTAATTCCGTGCCAGCA	TTCAGACTTACGTCCATTGACC
Pig12Fw:Pig84Rv	ACCGGCTAATTCCGTGCCAGCA	CGGCCTACGCTCCCTTTAAACC
Pig12Fw:Pig85Rv	ACCGGCTAATTCCGTGCCAGCA	TATCTAAGCATTTCACCGCTAC
Pig12Fw:Pig86Rv	ACCGGCTAATTCCGTGCCAGCA	GTTCAGACTTACGTCCATTGAC
Pig12Fw:Pig87Rv	ACCGGCTAATTCCGTGCCAGCA	ACGCTACTTGGCTGGTTCAGAC
Pig12Fw:Pig88Rv	ACCGGCTAATTCCGTGCCAGCA	TCTAAGCATTTCACCGCTACAC
Pig12Fw:Pig89Rv	ACCGGCTAATTCCGTGCCAGCA	CCGGCCTACGCTCCCTTTAAAC
Pig12Fw:Pig90Rv	ACCGGCTAATTCCGTGCCAGCA	AAGCCGGCCTACGCTCCCTTTA
Pig12Fw:Pig91Rv	ACCGGCTAATTCCGTGCCAGCA	GCGGCATTTCACAACACGCTTA
Pig12Fw:Pig92Rv	ACCGGCTAATTCCGTGCCAGCA	GCACGGAATTAGCCGGTCCTTA
Pig12Fw:Pig93Rv	ACCGGCTAATTCCGTGCCAGCA	TCGGAGTTCTTCGTGATATCTA
Pig12Fw:Pig94Rv	ACCGGCTAATTCCGTGCCAGCA	GCTACACCACGAATTCCGCCTA
Pig12Fw:Pig95Rv	ACCGGCTAATTCCGTGCCAGCA	GCAATCGGAGTTCTTCGTGATA
Pig12Fw:Pig96Rv	ACCGGCTAATTCCGTGCCAGCA	TACGCTCCCTTTAAACCCAATA
Pig12Fw:Pig97Rv	ACCGGCTAATTCCGTGCCAGCA	GGTTCAGACTTACGTCCATTGA
Pig12Fw:Pig98Rv	ACCGGCTAATTCCGTGCCAGCA	TCGCAATCGGAGTTCTTCGTGA
Pig12Fw:Pig99Rv	ACCGGCTAATTCCGTGCCAGCA	GTAAGCTGCCTTCGCAATCGGA
Pig12Fw:Pig100Rv	ACCGGCTAATTCCGTGCCAGCA	CACGCTACTTGGCTGGTTCAGA
Pig12Fw:Pig101Rv	ACCGGCTAATTCCGTGCCAGCA	TGCACGCTACTTGGCTGGTTCA
Pig12Fw:Pig102Rv	ACCGGCTAATTCCGTGCCAGCA	ATACCCGCACTTTCGAGCTTCA
Pig12Fw:Pig103Rv	ACCGGCTAATTCCGTGCCAGCA	GCACTTTCGAGCTTCAGCGTCA
Pig12Fw:Pig104Rv	ACCGGCTAATTCCGTGCCAGCA	TTTACAACCCATAGGGCCGTCA
Pig12Fw:Pig105Rv	ACCGGCTAATTCCGTGCCAGCA	CCTTATTCATGCGGTACCTGCA
Pig12Fw:Pig106Rv	ACCGGCTAATTCCGTGCCAGCA	GCTACGGTAAGCTGCCTTCGCA
Pig12Fw:Pig107Rv	ACCGGCTAATTCCGTGCCAGCA	GGCTGGTTCAGACTTACGTCCA
Pig12Fw:Pig108Rv	ACCGGCTAATTCCGTGCCAGCA	GCCTACGCTCCCTTTAAACCCA
Pig12Fw:Pig109Rv	ACCGGCTAATTCCGTGCCAGCA	TCAGACTTACGTCCATTGACCA
Pig12Fw:Pig110Rv	ACCGGCTAATTCCGTGCCAGCA	ATCTAAGCATTTCACCGCTACA
Pig12Fw:Pig111Rv	ACCGGCTAATTCCGTGCCAGCA	AGCCGGCCTACGCTCCCTTTAA
Pig12Fw:Pig112Rv	ACCGGCTAATTCCGTGCCAGCA	CGGCATTTCACAACACGCTTAA
Pig12Fw:Pig113Rv	ACCGGCTAATTCCGTGCCAGCA	CGGAGTTCTTCGTGATATCTAA
Pig12Fw:Pig114Rv	ACCGGCTAATTCCGTGCCAGCA	ACGCTCCCTTTAAACCCAATAA
Pig12Fw:Pig115Rv	ACCGGCTAATTCCGTGCCAGCA	CTTATTCATGCGGTACCTGCAA
Pig12Fw:Pig116Rv	ACCGGCTAATTCCGTGCCAGCA	CTACGGTAAGCTGCCTTCGCAA
Pig12Fw:Pig117Rv	ACCGGCTAATTCCGTGCCAGCA	CCTACGCTCCCTTTAAACCCAA
Pig12Fw:Pig118Rv	ACCGGCTAATTCCGTGCCAGCA	CAGACTTACGTCCATTGACCAA
Pig12Fw:Pig119Rv	ACCGGCTAATTCCGTGCCAGCA	GCCGGCCTACGCTCCCTTTAAA
Pig12Fw:Pig120Rv	ACCGGCTAATTCCGTGCCAGCA	GGCATTTCACAACACGCTTAAA
Pig12Fw:Pig121Rv	ACCGGCTAATTCCGTGCCAGCA	TTATTCATGCGGTACCTGCAAA
Pig13Fw:Pig1Rv	ACGCTGAAGCTCGAAAGTGCGG	CCTGCACGCTACTTGGCTGGTT
Pig13Fw:Pig2Rv	ACGCTGAAGCTCGAAAGTGCGG	AGCTGCCTTCGCAATCGGAGTT
Pig13Fw:Pig3Rv	ACGCTGAAGCTCGAAAGTGCGG	TGCCTTCGCAATCGGAGTTCTT
Pig13Fw:Pig4Rv	ACGCTGAAGCTCGAAAGTGCGG	CGCGGCATTTCACAACACGCTT
Pig13Fw:Pig5Rv	ACGCTGAAGCTCGAAAGTGCGG	CGATACCCGCACTTTCGAGCTT
Pig13Fw:Pig6Rv	ACGCTGAAGCTCGAAAGTGCGG	GGCACGGAATTAGCCGGTCCTT
Pig13Fw:Pig7Rv	ACGCTGAAGCTCGAAAGTGCGG	TAACGCTACGGTAAGCTGCCTT
Pig13Fw:Pig8Rv	ACGCTGAAGCTCGAAAGTGCGG	GCCGTCATCCTGCACGCTACTT
Pig13Fw:Pig9Rv	ACGCTGAAGCTCGAAAGTGCGG	ACGGAATTAGCCGGTCCTTATT
Pig13Fw:Pig10Rv	ACGCTGAAGCTCGAAAGTGCGG	CTGGTTCAGACTTACGTCCATT
Pig13Fw:Pig11Rv	ACGCTGAAGCTCGAAAGTGCGG	TCCTGCACGCTACTTGGCTGGT
Pig13Fw:Pig12Rv	ACGCTGAAGCTCGAAAGTGCGG	TGCTGGCACGGAATTAGCCGGT
Pig13Fw:Pig13Rv	ACGCTGAAGCTCGAAAGTGCGG	CCGCACTTTCGAGCTTCAGCGT
Pig13Fw:Pig14Rv	ACGCTGAAGCTCGAAAGTGCGG	AGTTTACAACCCATAGGGCCGT
Pig13Fw:Pig15Rv	ACGCTGAAGCTCGAAAGTGCGG	CTTGGCTGGTTCAGACTTACGT
Pig13Fw:Pig16Rv	ACGCTGAAGCTCGAAAGTGCGG	AAGCTGCCTTCGCAATCGGAGT
Pig13Fw:Pig17Rv	ACGCTGAAGCTCGAAAGTGCGG	CTGCCTTCGCAATCGGAGTTCT
Pig13Fw:Pig18Rv	ACGCTGAAGCTCGAAAGTGCGG	ATCGGAGTTCTTCGTGATATCT
Pig13Fw:Pig19Rv	ACGCTGAAGCTCGAAAGTGCGG	CTTCCGTATTACCGCGGCTGCT
Pig13Fw:Pig20Rv	ACGCTGAAGCTCGAAAGTGCGG	TCATCCTGCACGCTACTTGGCT
Pig13Fw:Pig21Rv	ACGCTGAAGCTCGAAAGTGCGG	GACCTTCCGTATTACCGCGGCT
Pig13Fw:Pig22Rv	ACGCTGAAGCTCGAAAGTGCGG	GATATCTAAGCATTTCACCGCT
Pig13Fw:Pig23Rv	ACGCTGAAGCTCGAAAGTGCGG	CCGCGGCATTTCACAACACGCT
Pig13Fw:Pig24Rv	ACGCTGAAGCTCGAAAGTGCGG	TGGCACGGAATTAGCCGGTCCT
Pig13Fw:Pig25Rv	ACGCTGAAGCTCGAAAGTGCGG	CAACCCATAGGGCCGTCATCCT
Pig13Fw:Pig26Rv	ACGCTGAAGCTCGAAAGTGCGG	CGCTACACCACGAATTCCGCCT
Pig13Fw:Pig27Rv	ACGCTGAAGCTCGAAAGTGCGG	GGTCCTTATTCATGCGGTACCT
Pig13Fw:Pig28Rv	ACGCTGAAGCTCGAAAGTGCGG	ACACCACGAATTCCGCCTACCT
Pig13Fw:Pig29Rv	ACGCTGAAGCTCGAAAGTGCGG	CGCTACTTGGCTGGTTCAGACT
Pig13Fw:Pig30Rv	ACGCTGAAGCTCGAAAGTGCGG	CACGGAATTAGCCGGTCCTTAT
Pig13Fw:Pig31Rv	ACGCTGAAGCTCGAAAGTGCGG	CAATCGGAGTTCTTCGTGATAT
Pig13Fw:Pig32Rv	ACGCTGAAGCTCGAAAGTGCGG	CGCAATCGGAGTTCTTCGTGAT
Pig13Fw:Pig33Rv	ACGCTGAAGCTCGAAAGTGCGG	TTACAACCCATAGGGCCGTCAT
Pig13Fw:Pig34Rv	ACGCTGAAGCTCGAAAGTGCGG	GCTGGTTCAGACTTACGTCCAT
Pig13Fw:Pig35Rv	ACGCTGAAGCTCGAAAGTGCGG	TACGGTAAGCTGCCTTCGCAAT
Pig13Fw:Pig36Rv	ACGCTGAAGCTCGAAAGTGCGG	CTACGCTCCCTTTAAACCCAAT
Pig13Fw:Pig37Rv	ACGCTGAAGCTCGAAAGTGCGG	CCGTCATCCTGCACGCTACTTG
Pig13Fw:Pig38Rv	ACGCTGAAGCTCGAAAGTGCGG	TGGTTCAGACTTACGTCCATTG
Pig13Fw:Pig39Rv	ACGCTGAAGCTCGAAAGTGCGG	TTCCGTATTACCGCGGCTGCTG
Pig13Fw:Pig40Rv	ACGCTGAAGCTCGAAAGTGCGG	CATCCTGCACGCTACTTGGCTG
Pig13Fw:Pig41Rv	ACGCTGAAGCTCGAAAGTGCGG	ACCTTCCGTATTACCGCGGCTG
Pig13Fw:Pig42Rv	ACGCTGAAGCTCGAAAGTGCGG	AACCCATAGGGCCGTCATCCTG
Pig13Fw:Pig43Rv	ACGCTGAAGCTCGAAAGTGCGG	GTCCTTATTCATGCGGTACCTG
Pig13Fw:Pig44Rv	ACGCTGAAGCTCGAAAGTGCGG	AATTAGCCGGTCCTTATTCATG
Pig13Fw:Pig45Rv	ACGCTGAAGCTCGAAAGTGCGG	CGTCATCCTGCACGCTACTTGG
Pig13Fw:Pig46Rv	ACGCTGAAGCTCGAAAGTGCGG	ATCCTGCACGCTACTTGGCTGG
Pig13Fw:Pig47Rv	ACGCTGAAGCTCGAAAGTGCGG	AAGCAGTTTACAACCCATAGGG
Pig13Fw:Pig48Rv	ACGCTGAAGCTCGAAAGTGCGG	GGTAAGCTGCCTTCGCAATCGG
Pig13Fw:Pig49Rv	ACGCTGAAGCTCGAAAGTGCGG	TAGCCGGTCCTTATTCATGCGG
Pig13Fw:Pig50Rv	ACGCTGAAGCTCGAAAGTGCGG	AAAGCAGTTTACAACCCATAGG
Pig13Fw:Pig51Rv	ACGCTGAAGCTCGAAAGTGCGG	ACGCTACGGTAAGCTGCCTTCG
Pig13Fw:Pig52Rv	ACGCTGAAGCTCGAAAGTGCGG	CGGTAAGCTGCCTTCGCAATCG
Pig13Fw:Pig53Rv	ACGCTGAAGCTCGAAAGTGCGG	TTAGCCGGTCCTTATTCATGCG
Pig13Fw:Pig54Rv	ACGCTGAAGCTCGAAAGTGCGG	CAGTTTACAACCCATAGGGCCG
Pig13Fw:Pig55Rv	ACGCTGAAGCTCGAAAGTGCGG	TAAGCTGCCTTCGCAATCGGAG
Pig13Fw:Pig56Rv	ACGCTGAAGCTCGAAAGTGCGG	GCACGCTACTTGGCTGGTTCAG
Pig13Fw:Pig57Rv	ACGCTGAAGCTCGAAAGTGCGG	TACCCGCACTTTCGAGCTTCAG
Pig13Fw:Pig58Rv	ACGCTGAAGCTCGAAAGTGCGG	GGAGTTCTTCGTGATATCTAAG
Pig13Fw:Pig59Rv	ACGCTGAAGCTCGAAAGTGCGG	CTGCACGCTACTTGGCTGGTTC
Pig13Fw:Pig60Rv	ACGCTGAAGCTCGAAAGTGCGG	GCTGCCTTCGCAATCGGAGTTC
Pig13Fw:Pig61Rv	ACGCTGAAGCTCGAAAGTGCGG	GATACCCGCACTTTCGAGCTTC
Pig13Fw:Pig62Rv	ACGCTGAAGCTCGAAAGTGCGG	AACGCTACGGTAAGCTGCCTTC
Pig13Fw:Pig63Rv	ACGCTGAAGCTCGAAAGTGCGG	CGCACTTTCGAGCTTCAGCGTC
Pig13Fw:Pig64Rv	ACGCTGAAGCTCGAAAGTGCGG	GTTTACAACCCATAGGGCCGTC
Pig13Fw:Pig65Rv	ACGCTGAAGCTCGAAAGTGCGG	TTGGCTGGTTCAGACTTACGTC
Pig13Fw:Pig66Rv	ACGCTGAAGCTCGAAAGTGCGG	CACCACGAATTCCGCCTACCTC
Pig13Fw:Pig67Rv	ACGCTGAAGCTCGAAAGTGCGG	AATCGGAGTTCTTCGTGATATC
Pig13Fw:Pig68Rv	ACGCTGAAGCTCGAAAGTGCGG	TACAACCCATAGGGCCGTCATC
Pig13Fw:Pig69Rv	ACGCTGAAGCTCGAAAGTGCGG	ACGGTAAGCTGCCTTCGCAATC
Pig13Fw:Pig70Rv	ACGCTGAAGCTCGAAAGTGCGG	TCCTTATTCATGCGGTACCTGC
Pig13Fw:Pig71Rv	ACGCTGAAGCTCGAAAGTGCGG	ATTAGCCGGTCCTTATTCATGC
Pig13Fw:Pig72Rv	ACGCTGAAGCTCGAAAGTGCGG	GTCATCCTGCACGCTACTTGGC
Pig13Fw:Pig73Rv	ACGCTGAAGCTCGAAAGTGCGG	AGCAGTTTACAACCCATAGGGC
Pig13Fw:Pig74Rv	ACGCTGAAGCTCGAAAGTGCGG	TGATATCTAAGCATTTCACCGC
Pig13Fw:Pig75Rv	ACGCTGAAGCTCGAAAGTGCGG	ACCCGCACTTTCGAGCTTCAGC
Pig13Fw:Pig76Rv	ACGCTGAAGCTCGAAAGTGCGG	GAGTTCTTCGTGATATCTAAGC
Pig13Fw:Pig77Rv	ACGCTGAAGCTCGAAAGTGCGG	TGGCTGGTTCAGACTTACGTCC
Pig13Fw:Pig78Rv	ACGCTGAAGCTCGAAAGTGCGG	ACCACGAATTCCGCCTACCTCC
Pig13Fw:Pig79Rv	ACGCTGAAGCTCGAAAGTGCGG	ACAACCCATAGGGCCGTCATCC
Pig13Fw:Pig80Rv	ACGCTGAAGCTCGAAAGTGCGG	GCAGTTTACAACCCATAGGGCC
Pig13Fw:Pig81Rv	ACGCTGAAGCTCGAAAGTGCGG	GGCCTACGCTCCCTTTAAACCC
Pig13Fw:Pig82Rv	ACGCTGAAGCTCGAAAGTGCGG	TACACCACGAATTCCGCCTACC
Pig13Fw:Pig83Rv	ACGCTGAAGCTCGAAAGTGCGG	TTCAGACTTACGTCCATTGACC
Pig13Fw:Pig84Rv	ACGCTGAAGCTCGAAAGTGCGG	CGGCCTACGCTCCCTTTAAACC
Pig13Fw:Pig85Rv	ACGCTGAAGCTCGAAAGTGCGG	TATCTAAGCATTTCACCGCTAC
Pig13Fw:Pig86Rv	ACGCTGAAGCTCGAAAGTGCGG	GTTCAGACTTACGTCCATTGAC
Pig13Fw:Pig87Rv	ACGCTGAAGCTCGAAAGTGCGG	ACGCTACTTGGCTGGTTCAGAC
Pig13Fw:Pig88Rv	ACGCTGAAGCTCGAAAGTGCGG	TCTAAGCATTTCACCGCTACAC
Pig13Fw:Pig89Rv	ACGCTGAAGCTCGAAAGTGCGG	CCGGCCTACGCTCCCTTTAAAC
Pig13Fw:Pig90Rv	ACGCTGAAGCTCGAAAGTGCGG	AAGCCGGCCTACGCTCCCTTTA
Pig13Fw:Pig91Rv	ACGCTGAAGCTCGAAAGTGCGG	GCGGCATTTCACAACACGCTTA
Pig13Fw:Pig92Rv	ACGCTGAAGCTCGAAAGTGCGG	GCACGGAATTAGCCGGTCCTTA
Pig13Fw:Pig93Rv	ACGCTGAAGCTCGAAAGTGCGG	TCGGAGTTCTTCGTGATATCTA
Pig13Fw:Pig94Rv	ACGCTGAAGCTCGAAAGTGCGG	GCTACACCACGAATTCCGCCTA
Pig13Fw:Pig95Rv	ACGCTGAAGCTCGAAAGTGCGG	GCAATCGGAGTTCTTCGTGATA
Pig13Fw:Pig96Rv	ACGCTGAAGCTCGAAAGTGCGG	TACGCTCCCTTTAAACCCAATA
Pig13Fw:Pig97Rv	ACGCTGAAGCTCGAAAGTGCGG	GGTTCAGACTTACGTCCATTGA
Pig13Fw:Pig98Rv	ACGCTGAAGCTCGAAAGTGCGG	TCGCAATCGGAGTTCTTCGTGA
Pig13Fw:Pig99Rv	ACGCTGAAGCTCGAAAGTGCGG	GTAAGCTGCCTTCGCAATCGGA
Pig13Fw:Pig100Rv	ACGCTGAAGCTCGAAAGTGCGG	CACGCTACTTGGCTGGTTCAGA
Pig13Fw:Pig101Rv	ACGCTGAAGCTCGAAAGTGCGG	TGCACGCTACTTGGCTGGTTCA
Pig13Fw:Pig102Rv	ACGCTGAAGCTCGAAAGTGCGG	ATACCCGCACTTTCGAGCTTCA
Pig13Fw:Pig103Rv	ACGCTGAAGCTCGAAAGTGCGG	GCACTTTCGAGCTTCAGCGTCA
Pig13Fw:Pig104Rv	ACGCTGAAGCTCGAAAGTGCGG	TTTACAACCCATAGGGCCGTCA
Pig13Fw:Pig105Rv	ACGCTGAAGCTCGAAAGTGCGG	CCTTATTCATGCGGTACCTGCA
Pig13Fw:Pig106Rv	ACGCTGAAGCTCGAAAGTGCGG	GCTACGGTAAGCTGCCTTCGCA
Pig13Fw:Pig107Rv	ACGCTGAAGCTCGAAAGTGCGG	GGCTGGTTCAGACTTACGTCCA
Pig13Fw:Pig108Rv	ACGCTGAAGCTCGAAAGTGCGG	GCCTACGCTCCCTTTAAACCCA
Pig13Fw:Pig109Rv	ACGCTGAAGCTCGAAAGTGCGG	TCAGACTTACGTCCATTGACCA
Pig13Fw:Pig110Rv	ACGCTGAAGCTCGAAAGTGCGG	ATCTAAGCATTTCACCGCTACA
Pig13Fw:Pig111Rv	ACGCTGAAGCTCGAAAGTGCGG	AGCCGGCCTACGCTCCCTTTAA
Pig13Fw:Pig112Rv	ACGCTGAAGCTCGAAAGTGCGG	CGGCATTTCACAACACGCTTAA
Pig13Fw:Pig113Rv	ACGCTGAAGCTCGAAAGTGCGG	CGGAGTTCTTCGTGATATCTAA
Pig13Fw:Pig114Rv	ACGCTGAAGCTCGAAAGTGCGG	ACGCTCCCTTTAAACCCAATAA
Pig13Fw:Pig115Rv	ACGCTGAAGCTCGAAAGTGCGG	CTTATTCATGCGGTACCTGCAA
Pig13Fw:Pig116Rv	ACGCTGAAGCTCGAAAGTGCGG	CTACGGTAAGCTGCCTTCGCAA
Pig13Fw:Pig117Rv	ACGCTGAAGCTCGAAAGTGCGG	CCTACGCTCCCTTTAAACCCAA
Pig13Fw:Pig118Rv	ACGCTGAAGCTCGAAAGTGCGG	CAGACTTACGTCCATTGACCAA
Pig13Fw:Pig119Rv	ACGCTGAAGCTCGAAAGTGCGG	GCCGGCCTACGCTCCCTTTAAA
Pig13Fw:Pig120Rv	ACGCTGAAGCTCGAAAGTGCGG	GGCATTTCACAACACGCTTAAA
Pig13Fw:Pig121Rv	ACGCTGAAGCTCGAAAGTGCGG	TTATTCATGCGGTACCTGCAAA
Pig14Fw:Pig1Rv	ACGGCCCTATGGGTTGTAAACT	CCTGCACGCTACTTGGCTGGTT
Pig14Fw:Pig2Rv	ACGGCCCTATGGGTTGTAAACT	AGCTGCCTTCGCAATCGGAGTT
Pig14Fw:Pig3Rv	ACGGCCCTATGGGTTGTAAACT	TGCCTTCGCAATCGGAGTTCTT
Pig14Fw:Pig4Rv	ACGGCCCTATGGGTTGTAAACT	CGCGGCATTTCACAACACGCTT
Pig14Fw:Pig5Rv	ACGGCCCTATGGGTTGTAAACT	CGATACCCGCACTTTCGAGCTT
Pig14Fw:Pig6Rv	ACGGCCCTATGGGTTGTAAACT	GGCACGGAATTAGCCGGTCCTT
Pig14Fw:Pig7Rv	ACGGCCCTATGGGTTGTAAACT	TAACGCTACGGTAAGCTGCCTT
Pig14Fw:Pig8Rv	ACGGCCCTATGGGTTGTAAACT	GCCGTCATCCTGCACGCTACTT
Pig14Fw:Pig9Rv	ACGGCCCTATGGGTTGTAAACT	ACGGAATTAGCCGGTCCTTATT
Pig14Fw:Pig10Rv	ACGGCCCTATGGGTTGTAAACT	CTGGTTCAGACTTACGTCCATT
Pig14Fw:Pig11Rv	ACGGCCCTATGGGTTGTAAACT	TCCTGCACGCTACTTGGCTGGT
Pig14Fw:Pig12Rv	ACGGCCCTATGGGTTGTAAACT	TGCTGGCACGGAATTAGCCGGT
Pig14Fw:Pig13Rv	ACGGCCCTATGGGTTGTAAACT	CCGCACTTTCGAGCTTCAGCGT
Pig14Fw:Pig14Rv	ACGGCCCTATGGGTTGTAAACT	AGTTTACAACCCATAGGGCCGT
Pig14Fw:Pig15Rv	ACGGCCCTATGGGTTGTAAACT	CTTGGCTGGTTCAGACTTACGT
Pig14Fw:Pig16Rv	ACGGCCCTATGGGTTGTAAACT	AAGCTGCCTTCGCAATCGGAGT
Pig14Fw:Pig17Rv	ACGGCCCTATGGGTTGTAAACT	CTGCCTTCGCAATCGGAGTTCT
Pig14Fw:Pig18Rv	ACGGCCCTATGGGTTGTAAACT	ATCGGAGTTCTTCGTGATATCT
Pig14Fw:Pig19Rv	ACGGCCCTATGGGTTGTAAACT	CTTCCGTATTACCGCGGCTGCT
Pig14Fw:Pig20Rv	ACGGCCCTATGGGTTGTAAACT	TCATCCTGCACGCTACTTGGCT
Pig14Fw:Pig21Rv	ACGGCCCTATGGGTTGTAAACT	GACCTTCCGTATTACCGCGGCT
Pig14Fw:Pig22Rv	ACGGCCCTATGGGTTGTAAACT	GATATCTAAGCATTTCACCGCT
Pig14Fw:Pig23Rv	ACGGCCCTATGGGTTGTAAACT	CCGCGGCATTTCACAACACGCT
Pig14Fw:Pig24Rv	ACGGCCCTATGGGTTGTAAACT	TGGCACGGAATTAGCCGGTCCT
Pig14Fw:Pig25Rv	ACGGCCCTATGGGTTGTAAACT	CAACCCATAGGGCCGTCATCCT
Pig14Fw:Pig26Rv	ACGGCCCTATGGGTTGTAAACT	CGCTACACCACGAATTCCGCCT
Pig14Fw:Pig27Rv	ACGGCCCTATGGGTTGTAAACT	GGTCCTTATTCATGCGGTACCT
Pig14Fw:Pig28Rv	ACGGCCCTATGGGTTGTAAACT	ACACCACGAATTCCGCCTACCT
Pig14Fw:Pig29Rv	ACGGCCCTATGGGTTGTAAACT	CGCTACTTGGCTGGTTCAGACT
Pig14Fw:Pig30Rv	ACGGCCCTATGGGTTGTAAACT	CACGGAATTAGCCGGTCCTTAT
Pig14Fw:Pig31Rv	ACGGCCCTATGGGTTGTAAACT	CAATCGGAGTTCTTCGTGATAT
Pig14Fw:Pig32Rv	ACGGCCCTATGGGTTGTAAACT	CGCAATCGGAGTTCTTCGTGAT
Pig14Fw:Pig33Rv	ACGGCCCTATGGGTTGTAAACT	TTACAACCCATAGGGCCGTCAT
Pig14Fw:Pig34Rv	ACGGCCCTATGGGTTGTAAACT	GCTGGTTCAGACTTACGTCCAT
Pig14Fw:Pig35Rv	ACGGCCCTATGGGTTGTAAACT	TACGGTAAGCTGCCTTCGCAAT
Pig14Fw:Pig36Rv	ACGGCCCTATGGGTTGTAAACT	CTACGCTCCCTTTAAACCCAAT
Pig14Fw:Pig37Rv	ACGGCCCTATGGGTTGTAAACT	CCGTCATCCTGCACGCTACTTG
Pig14Fw:Pig38Rv	ACGGCCCTATGGGTTGTAAACT	TGGTTCAGACTTACGTCCATTG
Pig14Fw:Pig39Rv	ACGGCCCTATGGGTTGTAAACT	TTCCGTATTACCGCGGCTGCTG
Pig14Fw:Pig40Rv	ACGGCCCTATGGGTTGTAAACT	CATCCTGCACGCTACTTGGCTG
Pig14Fw:Pig41Rv	ACGGCCCTATGGGTTGTAAACT	ACCTTCCGTATTACCGCGGCTG
Pig14Fw:Pig42Rv	ACGGCCCTATGGGTTGTAAACT	AACCCATAGGGCCGTCATCCTG
Pig14Fw:Pig43Rv	ACGGCCCTATGGGTTGTAAACT	GTCCTTATTCATGCGGTACCTG
Pig14Fw:Pig44Rv	ACGGCCCTATGGGTTGTAAACT	AATTAGCCGGTCCTTATTCATG
Pig14Fw:Pig45Rv	ACGGCCCTATGGGTTGTAAACT	CGTCATCCTGCACGCTACTTGG
Pig14Fw:Pig46Rv	ACGGCCCTATGGGTTGTAAACT	ATCCTGCACGCTACTTGGCTGG
Pig14Fw:Pig47Rv	ACGGCCCTATGGGTTGTAAACT	AAGCAGTTTACAACCCATAGGG
Pig14Fw:Pig48Rv	ACGGCCCTATGGGTTGTAAACT	GGTAAGCTGCCTTCGCAATCGG
Pig14Fw:Pig49Rv	ACGGCCCTATGGGTTGTAAACT	TAGCCGGTCCTTATTCATGCGG
Pig14Fw:Pig50Rv	ACGGCCCTATGGGTTGTAAACT	AAAGCAGTTTACAACCCATAGG
Pig14Fw:Pig51Rv	ACGGCCCTATGGGTTGTAAACT	ACGCTACGGTAAGCTGCCTTCG
Pig14Fw:Pig52Rv	ACGGCCCTATGGGTTGTAAACT	CGGTAAGCTGCCTTCGCAATCG
Pig14Fw:Pig53Rv	ACGGCCCTATGGGTTGTAAACT	TTAGCCGGTCCTTATTCATGCG
Pig14Fw:Pig54Rv	ACGGCCCTATGGGTTGTAAACT	CAGTTTACAACCCATAGGGCCG
Pig14Fw:Pig55Rv	ACGGCCCTATGGGTTGTAAACT	TAAGCTGCCTTCGCAATCGGAG
Pig14Fw:Pig56Rv	ACGGCCCTATGGGTTGTAAACT	GCACGCTACTTGGCTGGTTCAG
Pig14Fw:Pig57Rv	ACGGCCCTATGGGTTGTAAACT	TACCCGCACTTTCGAGCTTCAG
Pig14Fw:Pig58Rv	ACGGCCCTATGGGTTGTAAACT	GGAGTTCTTCGTGATATCTAAG
Pig14Fw:Pig59Rv	ACGGCCCTATGGGTTGTAAACT	CTGCACGCTACTTGGCTGGTTC
Pig14Fw:Pig60Rv	ACGGCCCTATGGGTTGTAAACT	GCTGCCTTCGCAATCGGAGTTC
Pig14Fw:Pig61Rv	ACGGCCCTATGGGTTGTAAACT	GATACCCGCACTTTCGAGCTTC
Pig14Fw:Pig62Rv	ACGGCCCTATGGGTTGTAAACT	AACGCTACGGTAAGCTGCCTTC
Pig14Fw:Pig63Rv	ACGGCCCTATGGGTTGTAAACT	CGCACTTTCGAGCTTCAGCGTC
Pig14Fw:Pig64Rv	ACGGCCCTATGGGTTGTAAACT	GTTTACAACCCATAGGGCCGTC
Pig14Fw:Pig65Rv	ACGGCCCTATGGGTTGTAAACT	TTGGCTGGTTCAGACTTACGTC
Pig14Fw:Pig66Rv	ACGGCCCTATGGGTTGTAAACT	CACCACGAATTCCGCCTACCTC
Pig14Fw:Pig67Rv	ACGGCCCTATGGGTTGTAAACT	AATCGGAGTTCTTCGTGATATC
Pig14Fw:Pig68Rv	ACGGCCCTATGGGTTGTAAACT	TACAACCCATAGGGCCGTCATC
Pig14Fw:Pig69Rv	ACGGCCCTATGGGTTGTAAACT	ACGGTAAGCTGCCTTCGCAATC
Pig14Fw:Pig70Rv	ACGGCCCTATGGGTTGTAAACT	TCCTTATTCATGCGGTACCTGC
Pig14Fw:Pig71Rv	ACGGCCCTATGGGTTGTAAACT	ATTAGCCGGTCCTTATTCATGC
Pig14Fw:Pig72Rv	ACGGCCCTATGGGTTGTAAACT	GTCATCCTGCACGCTACTTGGC
Pig14Fw:Pig73Rv	ACGGCCCTATGGGTTGTAAACT	AGCAGTTTACAACCCATAGGGC
Pig14Fw:Pig74Rv	ACGGCCCTATGGGTTGTAAACT	TGATATCTAAGCATTTCACCGC
Pig14Fw:Pig75Rv	ACGGCCCTATGGGTTGTAAACT	ACCCGCACTTTCGAGCTTCAGC
Pig14Fw:Pig76Rv	ACGGCCCTATGGGTTGTAAACT	GAGTTCTTCGTGATATCTAAGC
Pig14Fw:Pig77Rv	ACGGCCCTATGGGTTGTAAACT	TGGCTGGTTCAGACTTACGTCC
Pig14Fw:Pig78Rv	ACGGCCCTATGGGTTGTAAACT	ACCACGAATTCCGCCTACCTCC
Pig14Fw:Pig79Rv	ACGGCCCTATGGGTTGTAAACT	ACAACCCATAGGGCCGTCATCC
Pig14Fw:Pig80Rv	ACGGCCCTATGGGTTGTAAACT	GCAGTTTACAACCCATAGGGCC
Pig14Fw:Pig81Rv	ACGGCCCTATGGGTTGTAAACT	GGCCTACGCTCCCTTTAAACCC
Pig14Fw:Pig82Rv	ACGGCCCTATGGGTTGTAAACT	TACACCACGAATTCCGCCTACC
Pig14Fw:Pig83Rv	ACGGCCCTATGGGTTGTAAACT	TTCAGACTTACGTCCATTGACC
Pig14Fw:Pig84Rv	ACGGCCCTATGGGTTGTAAACT	CGGCCTACGCTCCCTTTAAACC
Pig14Fw:Pig85Rv	ACGGCCCTATGGGTTGTAAACT	TATCTAAGCATTTCACCGCTAC
Pig14Fw:Pig86Rv	ACGGCCCTATGGGTTGTAAACT	GTTCAGACTTACGTCCATTGAC
Pig14Fw:Pig87Rv	ACGGCCCTATGGGTTGTAAACT	ACGCTACTTGGCTGGTTCAGAC
Pig14Fw:Pig88Rv	ACGGCCCTATGGGTTGTAAACT	TCTAAGCATTTCACCGCTACAC
Pig14Fw:Pig89Rv	ACGGCCCTATGGGTTGTAAACT	CCGGCCTACGCTCCCTTTAAAC
Pig14Fw:Pig90Rv	ACGGCCCTATGGGTTGTAAACT	AAGCCGGCCTACGCTCCCTTTA
Pig14Fw:Pig91Rv	ACGGCCCTATGGGTTGTAAACT	GCGGCATTTCACAACACGCTTA
Pig14Fw:Pig92Rv	ACGGCCCTATGGGTTGTAAACT	GCACGGAATTAGCCGGTCCTTA
Pig14Fw:Pig93Rv	ACGGCCCTATGGGTTGTAAACT	TCGGAGTTCTTCGTGATATCTA
Pig14Fw:Pig94Rv	ACGGCCCTATGGGTTGTAAACT	GCTACACCACGAATTCCGCCTA
Pig14Fw:Pig95Rv	ACGGCCCTATGGGTTGTAAACT	GCAATCGGAGTTCTTCGTGATA
Pig14Fw:Pig96Rv	ACGGCCCTATGGGTTGTAAACT	TACGCTCCCTTTAAACCCAATA
Pig14Fw:Pig97Rv	ACGGCCCTATGGGTTGTAAACT	GGTTCAGACTTACGTCCATTGA
Pig14Fw:Pig98Rv	ACGGCCCTATGGGTTGTAAACT	TCGCAATCGGAGTTCTTCGTGA
Pig14Fw:Pig99Rv	ACGGCCCTATGGGTTGTAAACT	GTAAGCTGCCTTCGCAATCGGA
Pig14Fw:Pig100Rv	ACGGCCCTATGGGTTGTAAACT	CACGCTACTTGGCTGGTTCAGA
Pig14Fw:Pig101Rv	ACGGCCCTATGGGTTGTAAACT	TGCACGCTACTTGGCTGGTTCA
Pig14Fw:Pig102Rv	ACGGCCCTATGGGTTGTAAACT	ATACCCGCACTTTCGAGCTTCA
Pig14Fw:Pig103Rv	ACGGCCCTATGGGTTGTAAACT	GCACTTTCGAGCTTCAGCGTCA
Pig14Fw:Pig104Rv	ACGGCCCTATGGGTTGTAAACT	TTTACAACCCATAGGGCCGTCA
Pig14Fw:Pig105Rv	ACGGCCCTATGGGTTGTAAACT	CCTTATTCATGCGGTACCTGCA
Pig14Fw:Pig106Rv	ACGGCCCTATGGGTTGTAAACT	GCTACGGTAAGCTGCCTTCGCA
Pig14Fw:Pig107Rv	ACGGCCCTATGGGTTGTAAACT	GGCTGGTTCAGACTTACGTCCA
Pig14Fw:Pig108Rv	ACGGCCCTATGGGTTGTAAACT	GCCTACGCTCCCTTTAAACCCA
Pig14Fw:Pig109Rv	ACGGCCCTATGGGTTGTAAACT	TCAGACTTACGTCCATTGACCA
Pig14Fw:Pig110Rv	ACGGCCCTATGGGTTGTAAACT	ATCTAAGCATTTCACCGCTACA
Pig14Fw:Pig111Rv	ACGGCCCTATGGGTTGTAAACT	AGCCGGCCTACGCTCCCTTTAA
Pig14Fw:Pig112Rv	ACGGCCCTATGGGTTGTAAACT	CGGCATTTCACAACACGCTTAA
Pig14Fw:Pig113Rv	ACGGCCCTATGGGTTGTAAACT	CGGAGTTCTTCGTGATATCTAA
Pig14Fw:Pig114Rv	ACGGCCCTATGGGTTGTAAACT	ACGCTCCCTTTAAACCCAATAA
Pig14Fw:Pig115Rv	ACGGCCCTATGGGTTGTAAACT	CTTATTCATGCGGTACCTGCAA
Pig14Fw:Pig116Rv	ACGGCCCTATGGGTTGTAAACT	CTACGGTAAGCTGCCTTCGCAA
Pig14Fw:Pig117Rv	ACGGCCCTATGGGTTGTAAACT	CCTACGCTCCCTTTAAACCCAA
Pig14Fw:Pig118Rv	ACGGCCCTATGGGTTGTAAACT	CAGACTTACGTCCATTGACCAA
Pig14Fw:Pig119Rv	ACGGCCCTATGGGTTGTAAACT	GCCGGCCTACGCTCCCTTTAAA
Pig14Fw:Pig120Rv	ACGGCCCTATGGGTTGTAAACT	GGCATTTCACAACACGCTTAAA
Pig14Fw:Pig121Rv	ACGGCCCTATGGGTTGTAAACT	TTATTCATGCGGTACCTGCAAA
Pig15Fw:Pig1Rv	ACGTAAGTCTGAACCAGCCAAG	CCTGCACGCTACTTGGCTGGTT
Pig15Fw:Pig2Rv	ACGTAAGTCTGAACCAGCCAAG	AGCTGCCTTCGCAATCGGAGTT
Pig15Fw:Pig3Rv	ACGTAAGTCTGAACCAGCCAAG	TGCCTTCGCAATCGGAGTTCTT
Pig15Fw:Pig4Rv	ACGTAAGTCTGAACCAGCCAAG	CGCGGCATTTCACAACACGCTT
Pig15Fw:Pig5Rv	ACGTAAGTCTGAACCAGCCAAG	CGATACCCGCACTTTCGAGCTT
Pig15Fw:Pig6Rv	ACGTAAGTCTGAACCAGCCAAG	GGCACGGAATTAGCCGGTCCTT
Pig15Fw:Pig7Rv	ACGTAAGTCTGAACCAGCCAAG	TAACGCTACGGTAAGCTGCCTT
Pig15Fw:Pig8Rv	ACGTAAGTCTGAACCAGCCAAG	GCCGTCATCCTGCACGCTACTT
Pig15Fw:Pig9Rv	ACGTAAGTCTGAACCAGCCAAG	ACGGAATTAGCCGGTCCTTATT
Pig15Fw:Pig10Rv	ACGTAAGTCTGAACCAGCCAAG	CTGGTTCAGACTTACGTCCATT
Pig15Fw:Pig11Rv	ACGTAAGTCTGAACCAGCCAAG	TCCTGCACGCTACTTGGCTGGT
Pig15Fw:Pig12Rv	ACGTAAGTCTGAACCAGCCAAG	TGCTGGCACGGAATTAGCCGGT
Pig15Fw:Pig13Rv	ACGTAAGTCTGAACCAGCCAAG	CCGCACTTTCGAGCTTCAGCGT
Pig15Fw:Pig14Rv	ACGTAAGTCTGAACCAGCCAAG	AGTTTACAACCCATAGGGCCGT
Pig15Fw:Pig15Rv	ACGTAAGTCTGAACCAGCCAAG	CTTGGCTGGTTCAGACTTACGT
Pig15Fw:Pig16Rv	ACGTAAGTCTGAACCAGCCAAG	AAGCTGCCTTCGCAATCGGAGT
Pig15Fw:Pig17Rv	ACGTAAGTCTGAACCAGCCAAG	CTGCCTTCGCAATCGGAGTTCT
Pig15Fw:Pig18Rv	ACGTAAGTCTGAACCAGCCAAG	ATCGGAGTTCTTCGTGATATCT
Pig15Fw:Pig19Rv	ACGTAAGTCTGAACCAGCCAAG	CTTCCGTATTACCGCGGCTGCT
Pig15Fw:Pig20Rv	ACGTAAGTCTGAACCAGCCAAG	TCATCCTGCACGCTACTTGGCT
Pig15Fw:Pig21Rv	ACGTAAGTCTGAACCAGCCAAG	GACCTTCCGTATTACCGCGGCT
Pig15Fw:Pig22Rv	ACGTAAGTCTGAACCAGCCAAG	GATATCTAAGCATTTCACCGCT
Pig15Fw:Pig23Rv	ACGTAAGTCTGAACCAGCCAAG	CCGCGGCATTTCACAACACGCT
Pig15Fw:Pig24Rv	ACGTAAGTCTGAACCAGCCAAG	TGGCACGGAATTAGCCGGTCCT
Pig15Fw:Pig25Rv	ACGTAAGTCTGAACCAGCCAAG	CAACCCATAGGGCCGTCATCCT
Pig15Fw:Pig26Rv	ACGTAAGTCTGAACCAGCCAAG	CGCTACACCACGAATTCCGCCT
Pig15Fw:Pig27Rv	ACGTAAGTCTGAACCAGCCAAG	GGTCCTTATTCATGCGGTACCT
Pig15Fw:Pig28Rv	ACGTAAGTCTGAACCAGCCAAG	ACACCACGAATTCCGCCTACCT
Pig15Fw:Pig29Rv	ACGTAAGTCTGAACCAGCCAAG	CGCTACTTGGCTGGTTCAGACT
Pig15Fw:Pig30Rv	ACGTAAGTCTGAACCAGCCAAG	CACGGAATTAGCCGGTCCTTAT
Pig15Fw:Pig31Rv	ACGTAAGTCTGAACCAGCCAAG	CAATCGGAGTTCTTCGTGATAT
Pig15Fw:Pig32Rv	ACGTAAGTCTGAACCAGCCAAG	CGCAATCGGAGTTCTTCGTGAT
Pig15Fw:Pig33Rv	ACGTAAGTCTGAACCAGCCAAG	TTACAACCCATAGGGCCGTCAT
Pig15Fw:Pig34Rv	ACGTAAGTCTGAACCAGCCAAG	GCTGGTTCAGACTTACGTCCAT
Pig15Fw:Pig35Rv	ACGTAAGTCTGAACCAGCCAAG	TACGGTAAGCTGCCTTCGCAAT
Pig15Fw:Pig36Rv	ACGTAAGTCTGAACCAGCCAAG	CTACGCTCCCTTTAAACCCAAT
Pig15Fw:Pig37Rv	ACGTAAGTCTGAACCAGCCAAG	CCGTCATCCTGCACGCTACTTG
Pig15Fw:Pig38Rv	ACGTAAGTCTGAACCAGCCAAG	TGGTTCAGACTTACGTCCATTG
Pig15Fw:Pig39Rv	ACGTAAGTCTGAACCAGCCAAG	TTCCGTATTACCGCGGCTGCTG
Pig15Fw:Pig40Rv	ACGTAAGTCTGAACCAGCCAAG	CATCCTGCACGCTACTTGGCTG
Pig15Fw:Pig41Rv	ACGTAAGTCTGAACCAGCCAAG	ACCTTCCGTATTACCGCGGCTG
Pig15Fw:Pig42Rv	ACGTAAGTCTGAACCAGCCAAG	AACCCATAGGGCCGTCATCCTG
Pig15Fw:Pig43Rv	ACGTAAGTCTGAACCAGCCAAG	GTCCTTATTCATGCGGTACCTG
Pig15Fw:Pig44Rv	ACGTAAGTCTGAACCAGCCAAG	AATTAGCCGGTCCTTATTCATG
Pig15Fw:Pig45Rv	ACGTAAGTCTGAACCAGCCAAG	CGTCATCCTGCACGCTACTTGG
Pig15Fw:Pig46Rv	ACGTAAGTCTGAACCAGCCAAG	ATCCTGCACGCTACTTGGCTGG
Pig15Fw:Pig47Rv	ACGTAAGTCTGAACCAGCCAAG	AAGCAGTTTACAACCCATAGGG
Pig15Fw:Pig48Rv	ACGTAAGTCTGAACCAGCCAAG	GGTAAGCTGCCTTCGCAATCGG
Pig15Fw:Pig49Rv	ACGTAAGTCTGAACCAGCCAAG	TAGCCGGTCCTTATTCATGCGG
Pig15Fw:Pig50Rv	ACGTAAGTCTGAACCAGCCAAG	AAAGCAGTTTACAACCCATAGG
Pig15Fw:Pig51Rv	ACGTAAGTCTGAACCAGCCAAG	ACGCTACGGTAAGCTGCCTTCG
Pig15Fw:Pig52Rv	ACGTAAGTCTGAACCAGCCAAG	CGGTAAGCTGCCTTCGCAATCG
Pig15Fw:Pig53Rv	ACGTAAGTCTGAACCAGCCAAG	TTAGCCGGTCCTTATTCATGCG
Pig15Fw:Pig54Rv	ACGTAAGTCTGAACCAGCCAAG	CAGTTTACAACCCATAGGGCCG
Pig15Fw:Pig55Rv	ACGTAAGTCTGAACCAGCCAAG	TAAGCTGCCTTCGCAATCGGAG
Pig15Fw:Pig56Rv	ACGTAAGTCTGAACCAGCCAAG	GCACGCTACTTGGCTGGTTCAG
Pig15Fw:Pig57Rv	ACGTAAGTCTGAACCAGCCAAG	TACCCGCACTTTCGAGCTTCAG
Pig15Fw:Pig58Rv	ACGTAAGTCTGAACCAGCCAAG	GGAGTTCTTCGTGATATCTAAG
Pig15Fw:Pig59Rv	ACGTAAGTCTGAACCAGCCAAG	CTGCACGCTACTTGGCTGGTTC
Pig15Fw:Pig60Rv	ACGTAAGTCTGAACCAGCCAAG	GCTGCCTTCGCAATCGGAGTTC
Pig15Fw:Pig61Rv	ACGTAAGTCTGAACCAGCCAAG	GATACCCGCACTTTCGAGCTTC
Pig15Fw:Pig62Rv	ACGTAAGTCTGAACCAGCCAAG	AACGCTACGGTAAGCTGCCTTC
Pig15Fw:Pig63Rv	ACGTAAGTCTGAACCAGCCAAG	CGCACTTTCGAGCTTCAGCGTC
Pig15Fw:Pig64Rv	ACGTAAGTCTGAACCAGCCAAG	GTTTACAACCCATAGGGCCGTC
Pig15Fw:Pig65Rv	ACGTAAGTCTGAACCAGCCAAG	TTGGCTGGTTCAGACTTACGTC
Pig15Fw:Pig66Rv	ACGTAAGTCTGAACCAGCCAAG	CACCACGAATTCCGCCTACCTC
Pig15Fw:Pig67Rv	ACGTAAGTCTGAACCAGCCAAG	AATCGGAGTTCTTCGTGATATC
Pig15Fw:Pig68Rv	ACGTAAGTCTGAACCAGCCAAG	TACAACCCATAGGGCCGTCATC
Pig15Fw:Pig69Rv	ACGTAAGTCTGAACCAGCCAAG	ACGGTAAGCTGCCTTCGCAATC
Pig15Fw:Pig70Rv	ACGTAAGTCTGAACCAGCCAAG	TCCTTATTCATGCGGTACCTGC
Pig15Fw:Pig71Rv	ACGTAAGTCTGAACCAGCCAAG	ATTAGCCGGTCCTTATTCATGC
Pig15Fw:Pig72Rv	ACGTAAGTCTGAACCAGCCAAG	GTCATCCTGCACGCTACTTGGC
Pig15Fw:Pig73Rv	ACGTAAGTCTGAACCAGCCAAG	AGCAGTTTACAACCCATAGGGC
Pig15Fw:Pig74Rv	ACGTAAGTCTGAACCAGCCAAG	TGATATCTAAGCATTTCACCGC
Pig15Fw:Pig75Rv	ACGTAAGTCTGAACCAGCCAAG	ACCCGCACTTTCGAGCTTCAGC
Pig15Fw:Pig76Rv	ACGTAAGTCTGAACCAGCCAAG	GAGTTCTTCGTGATATCTAAGC
Pig15Fw:Pig77Rv	ACGTAAGTCTGAACCAGCCAAG	TGGCTGGTTCAGACTTACGTCC
Pig15Fw:Pig78Rv	ACGTAAGTCTGAACCAGCCAAG	ACCACGAATTCCGCCTACCTCC
Pig15Fw:Pig79Rv	ACGTAAGTCTGAACCAGCCAAG	ACAACCCATAGGGCCGTCATCC
Pig15Fw:Pig80Rv	ACGTAAGTCTGAACCAGCCAAG	GCAGTTTACAACCCATAGGGCC
Pig15Fw:Pig81Rv	ACGTAAGTCTGAACCAGCCAAG	GGCCTACGCTCCCTTTAAACCC
Pig15Fw:Pig82Rv	ACGTAAGTCTGAACCAGCCAAG	TACACCACGAATTCCGCCTACC
Pig15Fw:Pig83Rv	ACGTAAGTCTGAACCAGCCAAG	TTCAGACTTACGTCCATTGACC
Pig15Fw:Pig84Rv	ACGTAAGTCTGAACCAGCCAAG	CGGCCTACGCTCCCTTTAAACC
Pig15Fw:Pig85Rv	ACGTAAGTCTGAACCAGCCAAG	TATCTAAGCATTTCACCGCTAC
Pig15Fw:Pig86Rv	ACGTAAGTCTGAACCAGCCAAG	GTTCAGACTTACGTCCATTGAC
Pig15Fw:Pig87Rv	ACGTAAGTCTGAACCAGCCAAG	ACGCTACTTGGCTGGTTCAGAC
Pig15Fw:Pig88Rv	ACGTAAGTCTGAACCAGCCAAG	TCTAAGCATTTCACCGCTACAC
Pig15Fw:Pig89Rv	ACGTAAGTCTGAACCAGCCAAG	CCGGCCTACGCTCCCTTTAAAC
Pig15Fw:Pig90Rv	ACGTAAGTCTGAACCAGCCAAG	AAGCCGGCCTACGCTCCCTTTA
Pig15Fw:Pig91Rv	ACGTAAGTCTGAACCAGCCAAG	GCGGCATTTCACAACACGCTTA
Pig15Fw:Pig92Rv	ACGTAAGTCTGAACCAGCCAAG	GCACGGAATTAGCCGGTCCTTA
Pig15Fw:Pig93Rv	ACGTAAGTCTGAACCAGCCAAG	TCGGAGTTCTTCGTGATATCTA
Pig15Fw:Pig94Rv	ACGTAAGTCTGAACCAGCCAAG	GCTACACCACGAATTCCGCCTA
Pig15Fw:Pig95Rv	ACGTAAGTCTGAACCAGCCAAG	GCAATCGGAGTTCTTCGTGATA
Pig15Fw:Pig96Rv	ACGTAAGTCTGAACCAGCCAAG	TACGCTCCCTTTAAACCCAATA
Pig15Fw:Pig97Rv	ACGTAAGTCTGAACCAGCCAAG	GGTTCAGACTTACGTCCATTGA
Pig15Fw:Pig98Rv	ACGTAAGTCTGAACCAGCCAAG	TCGCAATCGGAGTTCTTCGTGA
Pig15Fw:Pig99Rv	ACGTAAGTCTGAACCAGCCAAG	GTAAGCTGCCTTCGCAATCGGA
Pig15Fw:Pig100Rv	ACGTAAGTCTGAACCAGCCAAG	CACGCTACTTGGCTGGTTCAGA
Pig15Fw:Pig101Rv	ACGTAAGTCTGAACCAGCCAAG	TGCACGCTACTTGGCTGGTTCA
Pig15Fw:Pig102Rv	ACGTAAGTCTGAACCAGCCAAG	ATACCCGCACTTTCGAGCTTCA
Pig15Fw:Pig103Rv	ACGTAAGTCTGAACCAGCCAAG	GCACTTTCGAGCTTCAGCGTCA
Pig15Fw:Pig104Rv	ACGTAAGTCTGAACCAGCCAAG	TTTACAACCCATAGGGCCGTCA
Pig15Fw:Pig105Rv	ACGTAAGTCTGAACCAGCCAAG	CCTTATTCATGCGGTACCTGCA
Pig15Fw:Pig106Rv	ACGTAAGTCTGAACCAGCCAAG	GCTACGGTAAGCTGCCTTCGCA
Pig15Fw:Pig107Rv	ACGTAAGTCTGAACCAGCCAAG	GGCTGGTTCAGACTTACGTCCA
Pig15Fw:Pig108Rv	ACGTAAGTCTGAACCAGCCAAG	GCCTACGCTCCCTTTAAACCCA
Pig15Fw:Pig109Rv	ACGTAAGTCTGAACCAGCCAAG	TCAGACTTACGTCCATTGACCA
Pig15Fw:Pig110Rv	ACGTAAGTCTGAACCAGCCAAG	ATCTAAGCATTTCACCGCTACA
Pig15Fw:Pig111Rv	ACGTAAGTCTGAACCAGCCAAG	AGCCGGCCTACGCTCCCTTTAA
Pig15Fw:Pig112Rv	ACGTAAGTCTGAACCAGCCAAG	CGGCATTTCACAACACGCTTAA
Pig15Fw:Pig113Rv	ACGTAAGTCTGAACCAGCCAAG	CGGAGTTCTTCGTGATATCTAA
Pig15Fw:Pig114Rv	ACGTAAGTCTGAACCAGCCAAG	ACGCTCCCTTTAAACCCAATAA
Pig15Fw:Pig115Rv	ACGTAAGTCTGAACCAGCCAAG	CTTATTCATGCGGTACCTGCAA
Pig15Fw:Pig116Rv	ACGTAAGTCTGAACCAGCCAAG	CTACGGTAAGCTGCCTTCGCAA
Pig15Fw:Pig117Rv	ACGTAAGTCTGAACCAGCCAAG	CCTACGCTCCCTTTAAACCCAA
Pig15Fw:Pig118Rv	ACGTAAGTCTGAACCAGCCAAG	CAGACTTACGTCCATTGACCAA
Pig15Fw:Pig119Rv	ACGTAAGTCTGAACCAGCCAAG	GCCGGCCTACGCTCCCTTTAAA
Pig15Fw:Pig120Rv	ACGTAAGTCTGAACCAGCCAAG	GGCATTTCACAACACGCTTAAA
Pig15Fw:Pig121Rv	ACGTAAGTCTGAACCAGCCAAG	TTATTCATGCGGTACCTGCAAA
Pig16Fw:Pig1Rv	ACTCCGATTGCGAAGGCAGCTT	CCTGCACGCTACTTGGCTGGTT
Pig16Fw:Pig2Rv	ACTCCGATTGCGAAGGCAGCTT	AGCTGCCTTCGCAATCGGAGTT
Pig16Fw:Pig3Rv	ACTCCGATTGCGAAGGCAGCTT	TGCCTTCGCAATCGGAGTTCTT
Pig16Fw:Pig4Rv	ACTCCGATTGCGAAGGCAGCTT	CGCGGCATTTCACAACACGCTT
Pig16Fw:Pig5Rv	ACTCCGATTGCGAAGGCAGCTT	CGATACCCGCACTTTCGAGCTT
Pig16Fw:Pig6Rv	ACTCCGATTGCGAAGGCAGCTT	GGCACGGAATTAGCCGGTCCTT
Pig16Fw:Pig7Rv	ACTCCGATTGCGAAGGCAGCTT	TAACGCTACGGTAAGCTGCCTT
Pig16Fw:Pig8Rv	ACTCCGATTGCGAAGGCAGCTT	GCCGTCATCCTGCACGCTACTT
Pig16Fw:Pig9Rv	ACTCCGATTGCGAAGGCAGCTT	ACGGAATTAGCCGGTCCTTATT
Pig16Fw:Pig10Rv	ACTCCGATTGCGAAGGCAGCTT	CTGGTTCAGACTTACGTCCATT
Pig16Fw:Pig11Rv	ACTCCGATTGCGAAGGCAGCTT	TCCTGCACGCTACTTGGCTGGT
Pig16Fw:Pig12Rv	ACTCCGATTGCGAAGGCAGCTT	TGCTGGCACGGAATTAGCCGGT
Pig16Fw:Pig13Rv	ACTCCGATTGCGAAGGCAGCTT	CCGCACTTTCGAGCTTCAGCGT
Pig16Fw:Pig14Rv	ACTCCGATTGCGAAGGCAGCTT	AGTTTACAACCCATAGGGCCGT
Pig16Fw:Pig15Rv	ACTCCGATTGCGAAGGCAGCTT	CTTGGCTGGTTCAGACTTACGT
Pig16Fw:Pig16Rv	ACTCCGATTGCGAAGGCAGCTT	AAGCTGCCTTCGCAATCGGAGT
Pig16Fw:Pig17Rv	ACTCCGATTGCGAAGGCAGCTT	CTGCCTTCGCAATCGGAGTTCT
Pig16Fw:Pig18Rv	ACTCCGATTGCGAAGGCAGCTT	ATCGGAGTTCTTCGTGATATCT
Pig16Fw:Pig19Rv	ACTCCGATTGCGAAGGCAGCTT	CTTCCGTATTACCGCGGCTGCT
Pig16Fw:Pig20Rv	ACTCCGATTGCGAAGGCAGCTT	TCATCCTGCACGCTACTTGGCT
Pig16Fw:Pig21Rv	ACTCCGATTGCGAAGGCAGCTT	GACCTTCCGTATTACCGCGGCT
Pig16Fw:Pig22Rv	ACTCCGATTGCGAAGGCAGCTT	GATATCTAAGCATTTCACCGCT
Pig16Fw:Pig23Rv	ACTCCGATTGCGAAGGCAGCTT	CCGCGGCATTTCACAACACGCT
Pig16Fw:Pig24Rv	ACTCCGATTGCGAAGGCAGCTT	TGGCACGGAATTAGCCGGTCCT
Pig16Fw:Pig25Rv	ACTCCGATTGCGAAGGCAGCTT	CAACCCATAGGGCCGTCATCCT
Pig16Fw:Pig26Rv	ACTCCGATTGCGAAGGCAGCTT	CGCTACACCACGAATTCCGCCT
Pig16Fw:Pig27Rv	ACTCCGATTGCGAAGGCAGCTT	GGTCCTTATTCATGCGGTACCT
Pig16Fw:Pig28Rv	ACTCCGATTGCGAAGGCAGCTT	ACACCACGAATTCCGCCTACCT
Pig16Fw:Pig29Rv	ACTCCGATTGCGAAGGCAGCTT	CGCTACTTGGCTGGTTCAGACT
Pig16Fw:Pig30Rv	ACTCCGATTGCGAAGGCAGCTT	CACGGAATTAGCCGGTCCTTAT
Pig16Fw:Pig31Rv	ACTCCGATTGCGAAGGCAGCTT	CAATCGGAGTTCTTCGTGATAT
Pig16Fw:Pig32Rv	ACTCCGATTGCGAAGGCAGCTT	CGCAATCGGAGTTCTTCGTGAT
Pig16Fw:Pig33Rv	ACTCCGATTGCGAAGGCAGCTT	TTACAACCCATAGGGCCGTCAT
Pig16Fw:Pig34Rv	ACTCCGATTGCGAAGGCAGCTT	GCTGGTTCAGACTTACGTCCAT
Pig16Fw:Pig35Rv	ACTCCGATTGCGAAGGCAGCTT	TACGGTAAGCTGCCTTCGCAAT
Pig16Fw:Pig36Rv	ACTCCGATTGCGAAGGCAGCTT	CTACGCTCCCTTTAAACCCAAT
Pig16Fw:Pig37Rv	ACTCCGATTGCGAAGGCAGCTT	CCGTCATCCTGCACGCTACTTG
Pig16Fw:Pig38Rv	ACTCCGATTGCGAAGGCAGCTT	TGGTTCAGACTTACGTCCATTG
Pig16Fw:Pig39Rv	ACTCCGATTGCGAAGGCAGCTT	TTCCGTATTACCGCGGCTGCTG
Pig16Fw:Pig40Rv	ACTCCGATTGCGAAGGCAGCTT	CATCCTGCACGCTACTTGGCTG
Pig16Fw:Pig41Rv	ACTCCGATTGCGAAGGCAGCTT	ACCTTCCGTATTACCGCGGCTG
Pig16Fw:Pig42Rv	ACTCCGATTGCGAAGGCAGCTT	AACCCATAGGGCCGTCATCCTG
Pig16Fw:Pig43Rv	ACTCCGATTGCGAAGGCAGCTT	GTCCTTATTCATGCGGTACCTG
Pig16Fw:Pig44Rv	ACTCCGATTGCGAAGGCAGCTT	AATTAGCCGGTCCTTATTCATG
Pig16Fw:Pig45Rv	ACTCCGATTGCGAAGGCAGCTT	CGTCATCCTGCACGCTACTTGG
Pig16Fw:Pig46Rv	ACTCCGATTGCGAAGGCAGCTT	ATCCTGCACGCTACTTGGCTGG
Pig16Fw:Pig47Rv	ACTCCGATTGCGAAGGCAGCTT	AAGCAGTTTACAACCCATAGGG
Pig16Fw:Pig48Rv	ACTCCGATTGCGAAGGCAGCTT	GGTAAGCTGCCTTCGCAATCGG
Pig16Fw:Pig49Rv	ACTCCGATTGCGAAGGCAGCTT	TAGCCGGTCCTTATTCATGCGG
Pig16Fw:Pig50Rv	ACTCCGATTGCGAAGGCAGCTT	AAAGCAGTTTACAACCCATAGG
Pig16Fw:Pig51Rv	ACTCCGATTGCGAAGGCAGCTT	ACGCTACGGTAAGCTGCCTTCG
Pig16Fw:Pig52Rv	ACTCCGATTGCGAAGGCAGCTT	CGGTAAGCTGCCTTCGCAATCG
Pig16Fw:Pig53Rv	ACTCCGATTGCGAAGGCAGCTT	TTAGCCGGTCCTTATTCATGCG
Pig16Fw:Pig54Rv	ACTCCGATTGCGAAGGCAGCTT	CAGTTTACAACCCATAGGGCCG
Pig16Fw:Pig55Rv	ACTCCGATTGCGAAGGCAGCTT	TAAGCTGCCTTCGCAATCGGAG
Pig16Fw:Pig56Rv	ACTCCGATTGCGAAGGCAGCTT	GCACGCTACTTGGCTGGTTCAG
Pig16Fw:Pig57Rv	ACTCCGATTGCGAAGGCAGCTT	TACCCGCACTTTCGAGCTTCAG
Pig16Fw:Pig58Rv	ACTCCGATTGCGAAGGCAGCTT	GGAGTTCTTCGTGATATCTAAG
Pig16Fw:Pig59Rv	ACTCCGATTGCGAAGGCAGCTT	CTGCACGCTACTTGGCTGGTTC
Pig16Fw:Pig60Rv	ACTCCGATTGCGAAGGCAGCTT	GCTGCCTTCGCAATCGGAGTTC
Pig16Fw:Pig61Rv	ACTCCGATTGCGAAGGCAGCTT	GATACCCGCACTTTCGAGCTTC
Pig16Fw:Pig62Rv	ACTCCGATTGCGAAGGCAGCTT	AACGCTACGGTAAGCTGCCTTC
Pig16Fw:Pig63Rv	ACTCCGATTGCGAAGGCAGCTT	CGCACTTTCGAGCTTCAGCGTC
Pig16Fw:Pig64Rv	ACTCCGATTGCGAAGGCAGCTT	GTTTACAACCCATAGGGCCGTC
Pig16Fw:Pig65Rv	ACTCCGATTGCGAAGGCAGCTT	TTGGCTGGTTCAGACTTACGTC
Pig16Fw:Pig66Rv	ACTCCGATTGCGAAGGCAGCTT	CACCACGAATTCCGCCTACCTC
Pig16Fw:Pig67Rv	ACTCCGATTGCGAAGGCAGCTT	AATCGGAGTTCTTCGTGATATC
Pig16Fw:Pig68Rv	ACTCCGATTGCGAAGGCAGCTT	TACAACCCATAGGGCCGTCATC
Pig16Fw:Pig69Rv	ACTCCGATTGCGAAGGCAGCTT	ACGGTAAGCTGCCTTCGCAATC
Pig16Fw:Pig70Rv	ACTCCGATTGCGAAGGCAGCTT	TCCTTATTCATGCGGTACCTGC
Pig16Fw:Pig71Rv	ACTCCGATTGCGAAGGCAGCTT	ATTAGCCGGTCCTTATTCATGC
Pig16Fw:Pig72Rv	ACTCCGATTGCGAAGGCAGCTT	GTCATCCTGCACGCTACTTGGC
Pig16Fw:Pig73Rv	ACTCCGATTGCGAAGGCAGCTT	AGCAGTTTACAACCCATAGGGC
Pig16Fw:Pig74Rv	ACTCCGATTGCGAAGGCAGCTT	TGATATCTAAGCATTTCACCGC
Pig16Fw:Pig75Rv	ACTCCGATTGCGAAGGCAGCTT	ACCCGCACTTTCGAGCTTCAGC
Pig16Fw:Pig76Rv	ACTCCGATTGCGAAGGCAGCTT	GAGTTCTTCGTGATATCTAAGC
Pig16Fw:Pig77Rv	ACTCCGATTGCGAAGGCAGCTT	TGGCTGGTTCAGACTTACGTCC
Pig16Fw:Pig78Rv	ACTCCGATTGCGAAGGCAGCTT	ACCACGAATTCCGCCTACCTCC
Pig16Fw:Pig79Rv	ACTCCGATTGCGAAGGCAGCTT	ACAACCCATAGGGCCGTCATCC
Pig16Fw:Pig80Rv	ACTCCGATTGCGAAGGCAGCTT	GCAGTTTACAACCCATAGGGCC
Pig16Fw:Pig81Rv	ACTCCGATTGCGAAGGCAGCTT	GGCCTACGCTCCCTTTAAACCC
Pig16Fw:Pig82Rv	ACTCCGATTGCGAAGGCAGCTT	TACACCACGAATTCCGCCTACC
Pig16Fw:Pig83Rv	ACTCCGATTGCGAAGGCAGCTT	TTCAGACTTACGTCCATTGACC
Pig16Fw:Pig84Rv	ACTCCGATTGCGAAGGCAGCTT	CGGCCTACGCTCCCTTTAAACC
Pig16Fw:Pig85Rv	ACTCCGATTGCGAAGGCAGCTT	TATCTAAGCATTTCACCGCTAC
Pig16Fw:Pig86Rv	ACTCCGATTGCGAAGGCAGCTT	GTTCAGACTTACGTCCATTGAC
Pig16Fw:Pig87Rv	ACTCCGATTGCGAAGGCAGCTT	ACGCTACTTGGCTGGTTCAGAC
Pig16Fw:Pig88Rv	ACTCCGATTGCGAAGGCAGCTT	TCTAAGCATTTCACCGCTACAC
Pig16Fw:Pig89Rv	ACTCCGATTGCGAAGGCAGCTT	CCGGCCTACGCTCCCTTTAAAC
Pig16Fw:Pig90Rv	ACTCCGATTGCGAAGGCAGCTT	AAGCCGGCCTACGCTCCCTTTA
Pig16Fw:Pig91Rv	ACTCCGATTGCGAAGGCAGCTT	GCGGCATTTCACAACACGCTTA
Pig16Fw:Pig92Rv	ACTCCGATTGCGAAGGCAGCTT	GCACGGAATTAGCCGGTCCTTA
Pig16Fw:Pig93Rv	ACTCCGATTGCGAAGGCAGCTT	TCGGAGTTCTTCGTGATATCTA
Pig16Fw:Pig94Rv	ACTCCGATTGCGAAGGCAGCTT	GCTACACCACGAATTCCGCCTA
Pig16Fw:Pig95Rv	ACTCCGATTGCGAAGGCAGCTT	GCAATCGGAGTTCTTCGTGATA
Pig16Fw:Pig96Rv	ACTCCGATTGCGAAGGCAGCTT	TACGCTCCCTTTAAACCCAATA
Pig16Fw:Pig97Rv	ACTCCGATTGCGAAGGCAGCTT	GGTTCAGACTTACGTCCATTGA
Pig16Fw:Pig98Rv	ACTCCGATTGCGAAGGCAGCTT	TCGCAATCGGAGTTCTTCGTGA
Pig16Fw:Pig99Rv	ACTCCGATTGCGAAGGCAGCTT	GTAAGCTGCCTTCGCAATCGGA
Pig16Fw:Pig100Rv	ACTCCGATTGCGAAGGCAGCTT	CACGCTACTTGGCTGGTTCAGA
Pig16Fw:Pig101Rv	ACTCCGATTGCGAAGGCAGCTT	TGCACGCTACTTGGCTGGTTCA
Pig16Fw:Pig102Rv	ACTCCGATTGCGAAGGCAGCTT	ATACCCGCACTTTCGAGCTTCA
Pig16Fw:Pig103Rv	ACTCCGATTGCGAAGGCAGCTT	GCACTTTCGAGCTTCAGCGTCA
Pig16Fw:Pig104Rv	ACTCCGATTGCGAAGGCAGCTT	TTTACAACCCATAGGGCCGTCA
Pig16Fw:Pig105Rv	ACTCCGATTGCGAAGGCAGCTT	CCTTATTCATGCGGTACCTGCA
Pig16Fw:Pig106Rv	ACTCCGATTGCGAAGGCAGCTT	GCTACGGTAAGCTGCCTTCGCA
Pig16Fw:Pig107Rv	ACTCCGATTGCGAAGGCAGCTT	GGCTGGTTCAGACTTACGTCCA
Pig16Fw:Pig108Rv	ACTCCGATTGCGAAGGCAGCTT	GCCTACGCTCCCTTTAAACCCA
Pig16Fw:Pig109Rv	ACTCCGATTGCGAAGGCAGCTT	TCAGACTTACGTCCATTGACCA
Pig16Fw:Pig110Rv	ACTCCGATTGCGAAGGCAGCTT	ATCTAAGCATTTCACCGCTACA
Pig16Fw:Pig111Rv	ACTCCGATTGCGAAGGCAGCTT	AGCCGGCCTACGCTCCCTTTAA
Pig16Fw:Pig112Rv	ACTCCGATTGCGAAGGCAGCTT	CGGCATTTCACAACACGCTTAA
Pig16Fw:Pig113Rv	ACTCCGATTGCGAAGGCAGCTT	CGGAGTTCTTCGTGATATCTAA
Pig16Fw:Pig114Rv	ACTCCGATTGCGAAGGCAGCTT	ACGCTCCCTTTAAACCCAATAA
Pig16Fw:Pig115Rv	ACTCCGATTGCGAAGGCAGCTT	CTTATTCATGCGGTACCTGCAA
Pig16Fw:Pig116Rv	ACTCCGATTGCGAAGGCAGCTT	CTACGGTAAGCTGCCTTCGCAA
Pig16Fw:Pig117Rv	ACTCCGATTGCGAAGGCAGCTT	CCTACGCTCCCTTTAAACCCAA
Pig16Fw:Pig118Rv	ACTCCGATTGCGAAGGCAGCTT	CAGACTTACGTCCATTGACCAA
Pig16Fw:Pig119Rv	ACTCCGATTGCGAAGGCAGCTT	GCCGGCCTACGCTCCCTTTAAA
Pig16Fw:Pig120Rv	ACTCCGATTGCGAAGGCAGCTT	GGCATTTCACAACACGCTTAAA
Pig16Fw:Pig121Rv	ACTCCGATTGCGAAGGCAGCTT	TTATTCATGCGGTACCTGCAAA
Pig17Fw:Pig1Rv	AGAACTCCGATTGCGAAGGCAG	CCTGCACGCTACTTGGCTGGTT
Pig17Fw:Pig2Rv	AGAACTCCGATTGCGAAGGCAG	AGCTGCCTTCGCAATCGGAGTT
Pig17Fw:Pig3Rv	AGAACTCCGATTGCGAAGGCAG	TGCCTTCGCAATCGGAGTTCTT
Pig17Fw:Pig4Rv	AGAACTCCGATTGCGAAGGCAG	CGCGGCATTTCACAACACGCTT
Pig17Fw:Pig5Rv	AGAACTCCGATTGCGAAGGCAG	CGATACCCGCACTTTCGAGCTT
Pig17Fw:Pig6Rv	AGAACTCCGATTGCGAAGGCAG	GGCACGGAATTAGCCGGTCCTT
Pig17Fw:Pig7Rv	AGAACTCCGATTGCGAAGGCAG	TAACGCTACGGTAAGCTGCCTT
Pig17Fw:Pig8Rv	AGAACTCCGATTGCGAAGGCAG	GCCGTCATCCTGCACGCTACTT
Pig17Fw:Pig9Rv	AGAACTCCGATTGCGAAGGCAG	ACGGAATTAGCCGGTCCTTATT
Pig17Fw:Pig10Rv	AGAACTCCGATTGCGAAGGCAG	CTGGTTCAGACTTACGTCCATT
Pig17Fw:Pig11Rv	AGAACTCCGATTGCGAAGGCAG	TCCTGCACGCTACTTGGCTGGT
Pig17Fw:Pig12Rv	AGAACTCCGATTGCGAAGGCAG	TGCTGGCACGGAATTAGCCGGT
Pig17Fw:Pig13Rv	AGAACTCCGATTGCGAAGGCAG	CCGCACTTTCGAGCTTCAGCGT
Pig17Fw:Pig14Rv	AGAACTCCGATTGCGAAGGCAG	AGTTTACAACCCATAGGGCCGT
Pig17Fw:Pig15Rv	AGAACTCCGATTGCGAAGGCAG	CTTGGCTGGTTCAGACTTACGT
Pig17Fw:Pig16Rv	AGAACTCCGATTGCGAAGGCAG	AAGCTGCCTTCGCAATCGGAGT
Pig17Fw:Pig17Rv	AGAACTCCGATTGCGAAGGCAG	CTGCCTTCGCAATCGGAGTTCT
Pig17Fw:Pig18Rv	AGAACTCCGATTGCGAAGGCAG	ATCGGAGTTCTTCGTGATATCT
Pig17Fw:Pig19Rv	AGAACTCCGATTGCGAAGGCAG	CTTCCGTATTACCGCGGCTGCT
Pig17Fw:Pig20Rv	AGAACTCCGATTGCGAAGGCAG	TCATCCTGCACGCTACTTGGCT
Pig17Fw:Pig21Rv	AGAACTCCGATTGCGAAGGCAG	GACCTTCCGTATTACCGCGGCT
Pig17Fw:Pig22Rv	AGAACTCCGATTGCGAAGGCAG	GATATCTAAGCATTTCACCGCT
Pig17Fw:Pig23Rv	AGAACTCCGATTGCGAAGGCAG	CCGCGGCATTTCACAACACGCT
Pig17Fw:Pig24Rv	AGAACTCCGATTGCGAAGGCAG	TGGCACGGAATTAGCCGGTCCT
Pig17Fw:Pig25Rv	AGAACTCCGATTGCGAAGGCAG	CAACCCATAGGGCCGTCATCCT
Pig17Fw:Pig26Rv	AGAACTCCGATTGCGAAGGCAG	CGCTACACCACGAATTCCGCCT
Pig17Fw:Pig27Rv	AGAACTCCGATTGCGAAGGCAG	GGTCCTTATTCATGCGGTACCT
Pig17Fw:Pig28Rv	AGAACTCCGATTGCGAAGGCAG	ACACCACGAATTCCGCCTACCT
Pig17Fw:Pig29Rv	AGAACTCCGATTGCGAAGGCAG	CGCTACTTGGCTGGTTCAGACT
Pig17Fw:Pig30Rv	AGAACTCCGATTGCGAAGGCAG	CACGGAATTAGCCGGTCCTTAT
Pig17Fw:Pig31Rv	AGAACTCCGATTGCGAAGGCAG	CAATCGGAGTTCTTCGTGATAT
Pig17Fw:Pig32Rv	AGAACTCCGATTGCGAAGGCAG	CGCAATCGGAGTTCTTCGTGAT
Pig17Fw:Pig33Rv	AGAACTCCGATTGCGAAGGCAG	TTACAACCCATAGGGCCGTCAT
Pig17Fw:Pig34Rv	AGAACTCCGATTGCGAAGGCAG	GCTGGTTCAGACTTACGTCCAT
Pig17Fw:Pig35Rv	AGAACTCCGATTGCGAAGGCAG	TACGGTAAGCTGCCTTCGCAAT
Pig17Fw:Pig36Rv	AGAACTCCGATTGCGAAGGCAG	CTACGCTCCCTTTAAACCCAAT
Pig17Fw:Pig37Rv	AGAACTCCGATTGCGAAGGCAG	CCGTCATCCTGCACGCTACTTG
Pig17Fw:Pig38Rv	AGAACTCCGATTGCGAAGGCAG	TGGTTCAGACTTACGTCCATTG
Pig17Fw:Pig39Rv	AGAACTCCGATTGCGAAGGCAG	TTCCGTATTACCGCGGCTGCTG
Pig17Fw:Pig40Rv	AGAACTCCGATTGCGAAGGCAG	CATCCTGCACGCTACTTGGCTG
Pig17Fw:Pig41Rv	AGAACTCCGATTGCGAAGGCAG	ACCTTCCGTATTACCGCGGCTG
Pig17Fw:Pig42Rv	AGAACTCCGATTGCGAAGGCAG	AACCCATAGGGCCGTCATCCTG
Pig17Fw:Pig43Rv	AGAACTCCGATTGCGAAGGCAG	GTCCTTATTCATGCGGTACCTG
Pig17Fw:Pig44Rv	AGAACTCCGATTGCGAAGGCAG	AATTAGCCGGTCCTTATTCATG
Pig17Fw:Pig45Rv	AGAACTCCGATTGCGAAGGCAG	CGTCATCCTGCACGCTACTTGG
Pig17Fw:Pig46Rv	AGAACTCCGATTGCGAAGGCAG	ATCCTGCACGCTACTTGGCTGG
Pig17Fw:Pig47Rv	AGAACTCCGATTGCGAAGGCAG	AAGCAGTTTACAACCCATAGGG
Pig17Fw:Pig48Rv	AGAACTCCGATTGCGAAGGCAG	GGTAAGCTGCCTTCGCAATCGG
Pig17Fw:Pig49Rv	AGAACTCCGATTGCGAAGGCAG	TAGCCGGTCCTTATTCATGCGG
Pig17Fw:Pig50Rv	AGAACTCCGATTGCGAAGGCAG	AAAGCAGTTTACAACCCATAGG
Pig17Fw:Pig51Rv	AGAACTCCGATTGCGAAGGCAG	ACGCTACGGTAAGCTGCCTTCG
Pig17Fw:Pig52Rv	AGAACTCCGATTGCGAAGGCAG	CGGTAAGCTGCCTTCGCAATCG
Pig17Fw:Pig53Rv	AGAACTCCGATTGCGAAGGCAG	TTAGCCGGTCCTTATTCATGCG
Pig17Fw:Pig54Rv	AGAACTCCGATTGCGAAGGCAG	CAGTTTACAACCCATAGGGCCG
Pig17Fw:Pig55Rv	AGAACTCCGATTGCGAAGGCAG	TAAGCTGCCTTCGCAATCGGAG
Pig17Fw:Pig56Rv	AGAACTCCGATTGCGAAGGCAG	GCACGCTACTTGGCTGGTTCAG
Pig17Fw:Pig57Rv	AGAACTCCGATTGCGAAGGCAG	TACCCGCACTTTCGAGCTTCAG
Pig17Fw:Pig58Rv	AGAACTCCGATTGCGAAGGCAG	GGAGTTCTTCGTGATATCTAAG
Pig17Fw:Pig59Rv	AGAACTCCGATTGCGAAGGCAG	CTGCACGCTACTTGGCTGGTTC
Pig17Fw:Pig60Rv	AGAACTCCGATTGCGAAGGCAG	GCTGCCTTCGCAATCGGAGTTC
Pig17Fw:Pig61Rv	AGAACTCCGATTGCGAAGGCAG	GATACCCGCACTTTCGAGCTTC
Pig17Fw:Pig62Rv	AGAACTCCGATTGCGAAGGCAG	AACGCTACGGTAAGCTGCCTTC
Pig17Fw:Pig63Rv	AGAACTCCGATTGCGAAGGCAG	CGCACTTTCGAGCTTCAGCGTC
Pig17Fw:Pig64Rv	AGAACTCCGATTGCGAAGGCAG	GTTTACAACCCATAGGGCCGTC
Pig17Fw:Pig65Rv	AGAACTCCGATTGCGAAGGCAG	TTGGCTGGTTCAGACTTACGTC
Pig17Fw:Pig66Rv	AGAACTCCGATTGCGAAGGCAG	CACCACGAATTCCGCCTACCTC
Pig17Fw:Pig67Rv	AGAACTCCGATTGCGAAGGCAG	AATCGGAGTTCTTCGTGATATC
Pig17Fw:Pig68Rv	AGAACTCCGATTGCGAAGGCAG	TACAACCCATAGGGCCGTCATC
Pig17Fw:Pig69Rv	AGAACTCCGATTGCGAAGGCAG	ACGGTAAGCTGCCTTCGCAATC
Pig17Fw:Pig70Rv	AGAACTCCGATTGCGAAGGCAG	TCCTTATTCATGCGGTACCTGC
Pig17Fw:Pig71Rv	AGAACTCCGATTGCGAAGGCAG	ATTAGCCGGTCCTTATTCATGC
Pig17Fw:Pig72Rv	AGAACTCCGATTGCGAAGGCAG	GTCATCCTGCACGCTACTTGGC
Pig17Fw:Pig73Rv	AGAACTCCGATTGCGAAGGCAG	AGCAGTTTACAACCCATAGGGC
Pig17Fw:Pig74Rv	AGAACTCCGATTGCGAAGGCAG	TGATATCTAAGCATTTCACCGC
Pig17Fw:Pig75Rv	AGAACTCCGATTGCGAAGGCAG	ACCCGCACTTTCGAGCTTCAGC
Pig17Fw:Pig76Rv	AGAACTCCGATTGCGAAGGCAG	GAGTTCTTCGTGATATCTAAGC
Pig17Fw:Pig77Rv	AGAACTCCGATTGCGAAGGCAG	TGGCTGGTTCAGACTTACGTCC
Pig17Fw:Pig78Rv	AGAACTCCGATTGCGAAGGCAG	ACCACGAATTCCGCCTACCTCC
Pig17Fw:Pig79Rv	AGAACTCCGATTGCGAAGGCAG	ACAACCCATAGGGCCGTCATCC
Pig17Fw:Pig80Rv	AGAACTCCGATTGCGAAGGCAG	GCAGTTTACAACCCATAGGGCC
Pig17Fw:Pig81Rv	AGAACTCCGATTGCGAAGGCAG	GGCCTACGCTCCCTTTAAACCC
Pig17Fw:Pig82Rv	AGAACTCCGATTGCGAAGGCAG	TACACCACGAATTCCGCCTACC
Pig17Fw:Pig83Rv	AGAACTCCGATTGCGAAGGCAG	TTCAGACTTACGTCCATTGACC
Pig17Fw:Pig84Rv	AGAACTCCGATTGCGAAGGCAG	CGGCCTACGCTCCCTTTAAACC
Pig17Fw:Pig85Rv	AGAACTCCGATTGCGAAGGCAG	TATCTAAGCATTTCACCGCTAC
Pig17Fw:Pig86Rv	AGAACTCCGATTGCGAAGGCAG	GTTCAGACTTACGTCCATTGAC
Pig17Fw:Pig87Rv	AGAACTCCGATTGCGAAGGCAG	ACGCTACTTGGCTGGTTCAGAC
Pig17Fw:Pig88Rv	AGAACTCCGATTGCGAAGGCAG	TCTAAGCATTTCACCGCTACAC
Pig17Fw:Pig89Rv	AGAACTCCGATTGCGAAGGCAG	CCGGCCTACGCTCCCTTTAAAC
Pig17Fw:Pig90Rv	AGAACTCCGATTGCGAAGGCAG	AAGCCGGCCTACGCTCCCTTTA
Pig17Fw:Pig91Rv	AGAACTCCGATTGCGAAGGCAG	GCGGCATTTCACAACACGCTTA
Pig17Fw:Pig92Rv	AGAACTCCGATTGCGAAGGCAG	GCACGGAATTAGCCGGTCCTTA
Pig17Fw:Pig93Rv	AGAACTCCGATTGCGAAGGCAG	TCGGAGTTCTTCGTGATATCTA
Pig17Fw:Pig94Rv	AGAACTCCGATTGCGAAGGCAG	GCTACACCACGAATTCCGCCTA
Pig17Fw:Pig95Rv	AGAACTCCGATTGCGAAGGCAG	GCAATCGGAGTTCTTCGTGATA
Pig17Fw:Pig96Rv	AGAACTCCGATTGCGAAGGCAG	TACGCTCCCTTTAAACCCAATA
Pig17Fw:Pig97Rv	AGAACTCCGATTGCGAAGGCAG	GGTTCAGACTTACGTCCATTGA
Pig17Fw:Pig98Rv	AGAACTCCGATTGCGAAGGCAG	TCGCAATCGGAGTTCTTCGTGA
Pig17Fw:Pig99Rv	AGAACTCCGATTGCGAAGGCAG	GTAAGCTGCCTTCGCAATCGGA
Pig17Fw:Pig100Rv	AGAACTCCGATTGCGAAGGCAG	CACGCTACTTGGCTGGTTCAGA
Pig17Fw:Pig101Rv	AGAACTCCGATTGCGAAGGCAG	TGCACGCTACTTGGCTGGTTCA
Pig17Fw:Pig102Rv	AGAACTCCGATTGCGAAGGCAG	ATACCCGCACTTTCGAGCTTCA
Pig17Fw:Pig103Rv	AGAACTCCGATTGCGAAGGCAG	GCACTTTCGAGCTTCAGCGTCA
Pig17Fw:Pig104Rv	AGAACTCCGATTGCGAAGGCAG	TTTACAACCCATAGGGCCGTCA
Pig17Fw:Pig105Rv	AGAACTCCGATTGCGAAGGCAG	CCTTATTCATGCGGTACCTGCA
Pig17Fw:Pig106Rv	AGAACTCCGATTGCGAAGGCAG	GCTACGGTAAGCTGCCTTCGCA
Pig17Fw:Pig107Rv	AGAACTCCGATTGCGAAGGCAG	GGCTGGTTCAGACTTACGTCCA
Pig17Fw:Pig108Rv	AGAACTCCGATTGCGAAGGCAG	GCCTACGCTCCCTTTAAACCCA
Pig17Fw:Pig109Rv	AGAACTCCGATTGCGAAGGCAG	TCAGACTTACGTCCATTGACCA
Pig17Fw:Pig110Rv	AGAACTCCGATTGCGAAGGCAG	ATCTAAGCATTTCACCGCTACA
Pig17Fw:Pig111Rv	AGAACTCCGATTGCGAAGGCAG	AGCCGGCCTACGCTCCCTTTAA
Pig17Fw:Pig112Rv	AGAACTCCGATTGCGAAGGCAG	CGGCATTTCACAACACGCTTAA
Pig17Fw:Pig113Rv	AGAACTCCGATTGCGAAGGCAG	CGGAGTTCTTCGTGATATCTAA
Pig17Fw:Pig114Rv	AGAACTCCGATTGCGAAGGCAG	ACGCTCCCTTTAAACCCAATAA
Pig17Fw:Pig115Rv	AGAACTCCGATTGCGAAGGCAG	CTTATTCATGCGGTACCTGCAA
Pig17Fw:Pig116Rv	AGAACTCCGATTGCGAAGGCAG	CTACGGTAAGCTGCCTTCGCAA
Pig17Fw:Pig117Rv	AGAACTCCGATTGCGAAGGCAG	CCTACGCTCCCTTTAAACCCAA
Pig17Fw:Pig118Rv	AGAACTCCGATTGCGAAGGCAG	CAGACTTACGTCCATTGACCAA
Pig17Fw:Pig119Rv	AGAACTCCGATTGCGAAGGCAG	GCCGGCCTACGCTCCCTTTAAA
Pig17Fw:Pig120Rv	AGAACTCCGATTGCGAAGGCAG	GGCATTTCACAACACGCTTAAA
Pig17Fw:Pig121Rv	AGAACTCCGATTGCGAAGGCAG	TTATTCATGCGGTACCTGCAAA
Pig18Fw:Pig1Rv	AGATATCACGAAGAACTCCGAT	CCTGCACGCTACTTGGCTGGTT
Pig18Fw:Pig2Rv	AGATATCACGAAGAACTCCGAT	AGCTGCCTTCGCAATCGGAGTT
Pig18Fw:Pig3Rv	AGATATCACGAAGAACTCCGAT	TGCCTTCGCAATCGGAGTTCTT
Pig18Fw:Pig4Rv	AGATATCACGAAGAACTCCGAT	CGCGGCATTTCACAACACGCTT
Pig18Fw:Pig5Rv	AGATATCACGAAGAACTCCGAT	CGATACCCGCACTTTCGAGCTT
Pig18Fw:Pig6Rv	AGATATCACGAAGAACTCCGAT	GGCACGGAATTAGCCGGTCCTT
Pig18Fw:Pig7Rv	AGATATCACGAAGAACTCCGAT	TAACGCTACGGTAAGCTGCCTT
Pig18Fw:Pig8Rv	AGATATCACGAAGAACTCCGAT	GCCGTCATCCTGCACGCTACTT
Pig18Fw:Pig9Rv	AGATATCACGAAGAACTCCGAT	ACGGAATTAGCCGGTCCTTATT
Pig18Fw:Pig10Rv	AGATATCACGAAGAACTCCGAT	CTGGTTCAGACTTACGTCCATT
Pig18Fw:Pig11Rv	AGATATCACGAAGAACTCCGAT	TCCTGCACGCTACTTGGCTGGT
Pig18Fw:Pig12Rv	AGATATCACGAAGAACTCCGAT	TGCTGGCACGGAATTAGCCGGT
Pig18Fw:Pig13Rv	AGATATCACGAAGAACTCCGAT	CCGCACTTTCGAGCTTCAGCGT
Pig18Fw:Pig14Rv	AGATATCACGAAGAACTCCGAT	AGTTTACAACCCATAGGGCCGT
Pig18Fw:Pig15Rv	AGATATCACGAAGAACTCCGAT	CTTGGCTGGTTCAGACTTACGT
Pig18Fw:Pig16Rv	AGATATCACGAAGAACTCCGAT	AAGCTGCCTTCGCAATCGGAGT
Pig18Fw:Pig17Rv	AGATATCACGAAGAACTCCGAT	CTGCCTTCGCAATCGGAGTTCT
Pig18Fw:Pig18Rv	AGATATCACGAAGAACTCCGAT	ATCGGAGTTCTTCGTGATATCT
Pig18Fw:Pig19Rv	AGATATCACGAAGAACTCCGAT	CTTCCGTATTACCGCGGCTGCT
Pig18Fw:Pig20Rv	AGATATCACGAAGAACTCCGAT	TCATCCTGCACGCTACTTGGCT
Pig18Fw:Pig21Rv	AGATATCACGAAGAACTCCGAT	GACCTTCCGTATTACCGCGGCT
Pig18Fw:Pig22Rv	AGATATCACGAAGAACTCCGAT	GATATCTAAGCATTTCACCGCT
Pig18Fw:Pig23Rv	AGATATCACGAAGAACTCCGAT	CCGCGGCATTTCACAACACGCT
Pig18Fw:Pig24Rv	AGATATCACGAAGAACTCCGAT	TGGCACGGAATTAGCCGGTCCT
Pig18Fw:Pig25Rv	AGATATCACGAAGAACTCCGAT	CAACCCATAGGGCCGTCATCCT
Pig18Fw:Pig26Rv	AGATATCACGAAGAACTCCGAT	CGCTACACCACGAATTCCGCCT
Pig18Fw:Pig27Rv	AGATATCACGAAGAACTCCGAT	GGTCCTTATTCATGCGGTACCT
Pig18Fw:Pig28Rv	AGATATCACGAAGAACTCCGAT	ACACCACGAATTCCGCCTACCT
Pig18Fw:Pig29Rv	AGATATCACGAAGAACTCCGAT	CGCTACTTGGCTGGTTCAGACT
Pig18Fw:Pig30Rv	AGATATCACGAAGAACTCCGAT	CACGGAATTAGCCGGTCCTTAT
Pig18Fw:Pig31Rv	AGATATCACGAAGAACTCCGAT	CAATCGGAGTTCTTCGTGATAT
Pig18Fw:Pig32Rv	AGATATCACGAAGAACTCCGAT	CGCAATCGGAGTTCTTCGTGAT
Pig18Fw:Pig33Rv	AGATATCACGAAGAACTCCGAT	TTACAACCCATAGGGCCGTCAT
Pig18Fw:Pig34Rv	AGATATCACGAAGAACTCCGAT	GCTGGTTCAGACTTACGTCCAT
Pig18Fw:Pig35Rv	AGATATCACGAAGAACTCCGAT	TACGGTAAGCTGCCTTCGCAAT
Pig18Fw:Pig36Rv	AGATATCACGAAGAACTCCGAT	CTACGCTCCCTTTAAACCCAAT
Pig18Fw:Pig37Rv	AGATATCACGAAGAACTCCGAT	CCGTCATCCTGCACGCTACTTG
Pig18Fw:Pig38Rv	AGATATCACGAAGAACTCCGAT	TGGTTCAGACTTACGTCCATTG
Pig18Fw:Pig39Rv	AGATATCACGAAGAACTCCGAT	TTCCGTATTACCGCGGCTGCTG
Pig18Fw:Pig40Rv	AGATATCACGAAGAACTCCGAT	CATCCTGCACGCTACTTGGCTG
Pig18Fw:Pig41Rv	AGATATCACGAAGAACTCCGAT	ACCTTCCGTATTACCGCGGCTG
Pig18Fw:Pig42Rv	AGATATCACGAAGAACTCCGAT	AACCCATAGGGCCGTCATCCTG
Pig18Fw:Pig43Rv	AGATATCACGAAGAACTCCGAT	GTCCTTATTCATGCGGTACCTG
Pig18Fw:Pig44Rv	AGATATCACGAAGAACTCCGAT	AATTAGCCGGTCCTTATTCATG
Pig18Fw:Pig45Rv	AGATATCACGAAGAACTCCGAT	CGTCATCCTGCACGCTACTTGG
Pig18Fw:Pig46Rv	AGATATCACGAAGAACTCCGAT	ATCCTGCACGCTACTTGGCTGG
Pig18Fw:Pig47Rv	AGATATCACGAAGAACTCCGAT	AAGCAGTTTACAACCCATAGGG
Pig18Fw:Pig48Rv	AGATATCACGAAGAACTCCGAT	GGTAAGCTGCCTTCGCAATCGG
Pig18Fw:Pig49Rv	AGATATCACGAAGAACTCCGAT	TAGCCGGTCCTTATTCATGCGG
Pig18Fw:Pig50Rv	AGATATCACGAAGAACTCCGAT	AAAGCAGTTTACAACCCATAGG
Pig18Fw:Pig51Rv	AGATATCACGAAGAACTCCGAT	ACGCTACGGTAAGCTGCCTTCG
Pig18Fw:Pig52Rv	AGATATCACGAAGAACTCCGAT	CGGTAAGCTGCCTTCGCAATCG
Pig18Fw:Pig53Rv	AGATATCACGAAGAACTCCGAT	TTAGCCGGTCCTTATTCATGCG
Pig18Fw:Pig54Rv	AGATATCACGAAGAACTCCGAT	CAGTTTACAACCCATAGGGCCG
Pig18Fw:Pig55Rv	AGATATCACGAAGAACTCCGAT	TAAGCTGCCTTCGCAATCGGAG
Pig18Fw:Pig56Rv	AGATATCACGAAGAACTCCGAT	GCACGCTACTTGGCTGGTTCAG
Pig18Fw:Pig57Rv	AGATATCACGAAGAACTCCGAT	TACCCGCACTTTCGAGCTTCAG
Pig18Fw:Pig58Rv	AGATATCACGAAGAACTCCGAT	GGAGTTCTTCGTGATATCTAAG
Pig18Fw:Pig59Rv	AGATATCACGAAGAACTCCGAT	CTGCACGCTACTTGGCTGGTTC
Pig18Fw:Pig60Rv	AGATATCACGAAGAACTCCGAT	GCTGCCTTCGCAATCGGAGTTC
Pig18Fw:Pig61Rv	AGATATCACGAAGAACTCCGAT	GATACCCGCACTTTCGAGCTTC
Pig18Fw:Pig62Rv	AGATATCACGAAGAACTCCGAT	AACGCTACGGTAAGCTGCCTTC
Pig18Fw:Pig63Rv	AGATATCACGAAGAACTCCGAT	CGCACTTTCGAGCTTCAGCGTC
Pig18Fw:Pig64Rv	AGATATCACGAAGAACTCCGAT	GTTTACAACCCATAGGGCCGTC
Pig18Fw:Pig65Rv	AGATATCACGAAGAACTCCGAT	TTGGCTGGTTCAGACTTACGTC
Pig18Fw:Pig66Rv	AGATATCACGAAGAACTCCGAT	CACCACGAATTCCGCCTACCTC
Pig18Fw:Pig67Rv	AGATATCACGAAGAACTCCGAT	AATCGGAGTTCTTCGTGATATC
Pig18Fw:Pig68Rv	AGATATCACGAAGAACTCCGAT	TACAACCCATAGGGCCGTCATC
Pig18Fw:Pig69Rv	AGATATCACGAAGAACTCCGAT	ACGGTAAGCTGCCTTCGCAATC
Pig18Fw:Pig70Rv	AGATATCACGAAGAACTCCGAT	TCCTTATTCATGCGGTACCTGC
Pig18Fw:Pig71Rv	AGATATCACGAAGAACTCCGAT	ATTAGCCGGTCCTTATTCATGC
Pig18Fw:Pig72Rv	AGATATCACGAAGAACTCCGAT	GTCATCCTGCACGCTACTTGGC
Pig18Fw:Pig73Rv	AGATATCACGAAGAACTCCGAT	AGCAGTTTACAACCCATAGGGC
Pig18Fw:Pig74Rv	AGATATCACGAAGAACTCCGAT	TGATATCTAAGCATTTCACCGC
Pig18Fw:Pig75Rv	AGATATCACGAAGAACTCCGAT	ACCCGCACTTTCGAGCTTCAGC
Pig18Fw:Pig76Rv	AGATATCACGAAGAACTCCGAT	GAGTTCTTCGTGATATCTAAGC
Pig18Fw:Pig77Rv	AGATATCACGAAGAACTCCGAT	TGGCTGGTTCAGACTTACGTCC
Pig18Fw:Pig78Rv	AGATATCACGAAGAACTCCGAT	ACCACGAATTCCGCCTACCTCC
Pig18Fw:Pig79Rv	AGATATCACGAAGAACTCCGAT	ACAACCCATAGGGCCGTCATCC
Pig18Fw:Pig80Rv	AGATATCACGAAGAACTCCGAT	GCAGTTTACAACCCATAGGGCC
Pig18Fw:Pig81Rv	AGATATCACGAAGAACTCCGAT	GGCCTACGCTCCCTTTAAACCC
Pig18Fw:Pig82Rv	AGATATCACGAAGAACTCCGAT	TACACCACGAATTCCGCCTACC
Pig18Fw:Pig83Rv	AGATATCACGAAGAACTCCGAT	TTCAGACTTACGTCCATTGACC
Pig18Fw:Pig84Rv	AGATATCACGAAGAACTCCGAT	CGGCCTACGCTCCCTTTAAACC
Pig18Fw:Pig85Rv	AGATATCACGAAGAACTCCGAT	TATCTAAGCATTTCACCGCTAC
Pig18Fw:Pig86Rv	AGATATCACGAAGAACTCCGAT	GTTCAGACTTACGTCCATTGAC
Pig18Fw:Pig87Rv	AGATATCACGAAGAACTCCGAT	ACGCTACTTGGCTGGTTCAGAC
Pig18Fw:Pig88Rv	AGATATCACGAAGAACTCCGAT	TCTAAGCATTTCACCGCTACAC
Pig18Fw:Pig89Rv	AGATATCACGAAGAACTCCGAT	CCGGCCTACGCTCCCTTTAAAC
Pig18Fw:Pig90Rv	AGATATCACGAAGAACTCCGAT	AAGCCGGCCTACGCTCCCTTTA
Pig18Fw:Pig91Rv	AGATATCACGAAGAACTCCGAT	GCGGCATTTCACAACACGCTTA
Pig18Fw:Pig92Rv	AGATATCACGAAGAACTCCGAT	GCACGGAATTAGCCGGTCCTTA
Pig18Fw:Pig93Rv	AGATATCACGAAGAACTCCGAT	TCGGAGTTCTTCGTGATATCTA
Pig18Fw:Pig94Rv	AGATATCACGAAGAACTCCGAT	GCTACACCACGAATTCCGCCTA
Pig18Fw:Pig95Rv	AGATATCACGAAGAACTCCGAT	GCAATCGGAGTTCTTCGTGATA
Pig18Fw:Pig96Rv	AGATATCACGAAGAACTCCGAT	TACGCTCCCTTTAAACCCAATA
Pig18Fw:Pig97Rv	AGATATCACGAAGAACTCCGAT	GGTTCAGACTTACGTCCATTGA
Pig18Fw:Pig98Rv	AGATATCACGAAGAACTCCGAT	TCGCAATCGGAGTTCTTCGTGA
Pig18Fw:Pig99Rv	AGATATCACGAAGAACTCCGAT	GTAAGCTGCCTTCGCAATCGGA
Pig18Fw:Pig100Rv	AGATATCACGAAGAACTCCGAT	CACGCTACTTGGCTGGTTCAGA
Pig18Fw:Pig101Rv	AGATATCACGAAGAACTCCGAT	TGCACGCTACTTGGCTGGTTCA
Pig18Fw:Pig102Rv	AGATATCACGAAGAACTCCGAT	ATACCCGCACTTTCGAGCTTCA
Pig18Fw:Pig103Rv	AGATATCACGAAGAACTCCGAT	GCACTTTCGAGCTTCAGCGTCA
Pig18Fw:Pig104Rv	AGATATCACGAAGAACTCCGAT	TTTACAACCCATAGGGCCGTCA
Pig18Fw:Pig105Rv	AGATATCACGAAGAACTCCGAT	CCTTATTCATGCGGTACCTGCA
Pig18Fw:Pig106Rv	AGATATCACGAAGAACTCCGAT	GCTACGGTAAGCTGCCTTCGCA
Pig18Fw:Pig107Rv	AGATATCACGAAGAACTCCGAT	GGCTGGTTCAGACTTACGTCCA
Pig18Fw:Pig108Rv	AGATATCACGAAGAACTCCGAT	GCCTACGCTCCCTTTAAACCCA
Pig18Fw:Pig109Rv	AGATATCACGAAGAACTCCGAT	TCAGACTTACGTCCATTGACCA
Pig18Fw:Pig110Rv	AGATATCACGAAGAACTCCGAT	ATCTAAGCATTTCACCGCTACA
Pig18Fw:Pig111Rv	AGATATCACGAAGAACTCCGAT	AGCCGGCCTACGCTCCCTTTAA
Pig18Fw:Pig112Rv	AGATATCACGAAGAACTCCGAT	CGGCATTTCACAACACGCTTAA
Pig18Fw:Pig113Rv	AGATATCACGAAGAACTCCGAT	CGGAGTTCTTCGTGATATCTAA
Pig18Fw:Pig114Rv	AGATATCACGAAGAACTCCGAT	ACGCTCCCTTTAAACCCAATAA
Pig18Fw:Pig115Rv	AGATATCACGAAGAACTCCGAT	CTTATTCATGCGGTACCTGCAA
Pig18Fw:Pig116Rv	AGATATCACGAAGAACTCCGAT	CTACGGTAAGCTGCCTTCGCAA
Pig18Fw:Pig117Rv	AGATATCACGAAGAACTCCGAT	CCTACGCTCCCTTTAAACCCAA
Pig18Fw:Pig118Rv	AGATATCACGAAGAACTCCGAT	CAGACTTACGTCCATTGACCAA
Pig18Fw:Pig119Rv	AGATATCACGAAGAACTCCGAT	GCCGGCCTACGCTCCCTTTAAA
Pig18Fw:Pig120Rv	AGATATCACGAAGAACTCCGAT	GGCATTTCACAACACGCTTAAA
Pig18Fw:Pig121Rv	AGATATCACGAAGAACTCCGAT	TTATTCATGCGGTACCTGCAAA
Pig19Fw:Pig1Rv	AGCAGCCGCGGTAATACGGAAG	CCTGCACGCTACTTGGCTGGTT
Pig19Fw:Pig2Rv	AGCAGCCGCGGTAATACGGAAG	AGCTGCCTTCGCAATCGGAGTT
Pig19Fw:Pig3Rv	AGCAGCCGCGGTAATACGGAAG	TGCCTTCGCAATCGGAGTTCTT
Pig19Fw:Pig4Rv	AGCAGCCGCGGTAATACGGAAG	CGCGGCATTTCACAACACGCTT
Pig19Fw:Pig5Rv	AGCAGCCGCGGTAATACGGAAG	CGATACCCGCACTTTCGAGCTT
Pig19Fw:Pig6Rv	AGCAGCCGCGGTAATACGGAAG	GGCACGGAATTAGCCGGTCCTT
Pig19Fw:Pig7Rv	AGCAGCCGCGGTAATACGGAAG	TAACGCTACGGTAAGCTGCCTT
Pig19Fw:Pig8Rv	AGCAGCCGCGGTAATACGGAAG	GCCGTCATCCTGCACGCTACTT
Pig19Fw:Pig9Rv	AGCAGCCGCGGTAATACGGAAG	ACGGAATTAGCCGGTCCTTATT
Pig19Fw:Pig10Rv	AGCAGCCGCGGTAATACGGAAG	CTGGTTCAGACTTACGTCCATT
Pig19Fw:Pig11Rv	AGCAGCCGCGGTAATACGGAAG	TCCTGCACGCTACTTGGCTGGT
Pig19Fw:Pig12Rv	AGCAGCCGCGGTAATACGGAAG	TGCTGGCACGGAATTAGCCGGT
Pig19Fw:Pig13Rv	AGCAGCCGCGGTAATACGGAAG	CCGCACTTTCGAGCTTCAGCGT
Pig19Fw:Pig14Rv	AGCAGCCGCGGTAATACGGAAG	AGTTTACAACCCATAGGGCCGT
Pig19Fw:Pig15Rv	AGCAGCCGCGGTAATACGGAAG	CTTGGCTGGTTCAGACTTACGT
Pig19Fw:Pig16Rv	AGCAGCCGCGGTAATACGGAAG	AAGCTGCCTTCGCAATCGGAGT
Pig19Fw:Pig17Rv	AGCAGCCGCGGTAATACGGAAG	CTGCCTTCGCAATCGGAGTTCT
Pig19Fw:Pig18Rv	AGCAGCCGCGGTAATACGGAAG	ATCGGAGTTCTTCGTGATATCT
Pig19Fw:Pig19Rv	AGCAGCCGCGGTAATACGGAAG	CTTCCGTATTACCGCGGCTGCT
Pig19Fw:Pig20Rv	AGCAGCCGCGGTAATACGGAAG	TCATCCTGCACGCTACTTGGCT
Pig19Fw:Pig21Rv	AGCAGCCGCGGTAATACGGAAG	GACCTTCCGTATTACCGCGGCT
Pig19Fw:Pig22Rv	AGCAGCCGCGGTAATACGGAAG	GATATCTAAGCATTTCACCGCT
Pig19Fw:Pig23Rv	AGCAGCCGCGGTAATACGGAAG	CCGCGGCATTTCACAACACGCT
Pig19Fw:Pig24Rv	AGCAGCCGCGGTAATACGGAAG	TGGCACGGAATTAGCCGGTCCT
Pig19Fw:Pig25Rv	AGCAGCCGCGGTAATACGGAAG	CAACCCATAGGGCCGTCATCCT
Pig19Fw:Pig26Rv	AGCAGCCGCGGTAATACGGAAG	CGCTACACCACGAATTCCGCCT
Pig19Fw:Pig27Rv	AGCAGCCGCGGTAATACGGAAG	GGTCCTTATTCATGCGGTACCT
Pig19Fw:Pig28Rv	AGCAGCCGCGGTAATACGGAAG	ACACCACGAATTCCGCCTACCT
Pig19Fw:Pig29Rv	AGCAGCCGCGGTAATACGGAAG	CGCTACTTGGCTGGTTCAGACT
Pig19Fw:Pig30Rv	AGCAGCCGCGGTAATACGGAAG	CACGGAATTAGCCGGTCCTTAT
Pig19Fw:Pig31Rv	AGCAGCCGCGGTAATACGGAAG	CAATCGGAGTTCTTCGTGATAT
Pig19Fw:Pig32Rv	AGCAGCCGCGGTAATACGGAAG	CGCAATCGGAGTTCTTCGTGAT
Pig19Fw:Pig33Rv	AGCAGCCGCGGTAATACGGAAG	TTACAACCCATAGGGCCGTCAT
Pig19Fw:Pig34Rv	AGCAGCCGCGGTAATACGGAAG	GCTGGTTCAGACTTACGTCCAT
Pig19Fw:Pig35Rv	AGCAGCCGCGGTAATACGGAAG	TACGGTAAGCTGCCTTCGCAAT
Pig19Fw:Pig36Rv	AGCAGCCGCGGTAATACGGAAG	CTACGCTCCCTTTAAACCCAAT
Pig19Fw:Pig37Rv	AGCAGCCGCGGTAATACGGAAG	CCGTCATCCTGCACGCTACTTG
Pig19Fw:Pig38Rv	AGCAGCCGCGGTAATACGGAAG	TGGTTCAGACTTACGTCCATTG
Pig19Fw:Pig39Rv	AGCAGCCGCGGTAATACGGAAG	TTCCGTATTACCGCGGCTGCTG
Pig19Fw:Pig40Rv	AGCAGCCGCGGTAATACGGAAG	CATCCTGCACGCTACTTGGCTG
Pig19Fw:Pig41Rv	AGCAGCCGCGGTAATACGGAAG	ACCTTCCGTATTACCGCGGCTG
Pig19Fw:Pig42Rv	AGCAGCCGCGGTAATACGGAAG	AACCCATAGGGCCGTCATCCTG
Pig19Fw:Pig43Rv	AGCAGCCGCGGTAATACGGAAG	GTCCTTATTCATGCGGTACCTG
Pig19Fw:Pig44Rv	AGCAGCCGCGGTAATACGGAAG	AATTAGCCGGTCCTTATTCATG
Pig19Fw:Pig45Rv	AGCAGCCGCGGTAATACGGAAG	CGTCATCCTGCACGCTACTTGG
Pig19Fw:Pig46Rv	AGCAGCCGCGGTAATACGGAAG	ATCCTGCACGCTACTTGGCTGG
Pig19Fw:Pig47Rv	AGCAGCCGCGGTAATACGGAAG	AAGCAGTTTACAACCCATAGGG
Pig19Fw:Pig48Rv	AGCAGCCGCGGTAATACGGAAG	GGTAAGCTGCCTTCGCAATCGG
Pig19Fw:Pig49Rv	AGCAGCCGCGGTAATACGGAAG	TAGCCGGTCCTTATTCATGCGG
Pig19Fw:Pig50Rv	AGCAGCCGCGGTAATACGGAAG	AAAGCAGTTTACAACCCATAGG
Pig19Fw:Pig51Rv	AGCAGCCGCGGTAATACGGAAG	ACGCTACGGTAAGCTGCCTTCG
Pig19Fw:Pig52Rv	AGCAGCCGCGGTAATACGGAAG	CGGTAAGCTGCCTTCGCAATCG
Pig19Fw:Pig53Rv	AGCAGCCGCGGTAATACGGAAG	TTAGCCGGTCCTTATTCATGCG
Pig19Fw:Pig54Rv	AGCAGCCGCGGTAATACGGAAG	CAGTTTACAACCCATAGGGCCG
Pig19Fw:Pig55Rv	AGCAGCCGCGGTAATACGGAAG	TAAGCTGCCTTCGCAATCGGAG
Pig19Fw:Pig56Rv	AGCAGCCGCGGTAATACGGAAG	GCACGCTACTTGGCTGGTTCAG
Pig19Fw:Pig57Rv	AGCAGCCGCGGTAATACGGAAG	TACCCGCACTTTCGAGCTTCAG
Pig19Fw:Pig58Rv	AGCAGCCGCGGTAATACGGAAG	GGAGTTCTTCGTGATATCTAAG
Pig19Fw:Pig59Rv	AGCAGCCGCGGTAATACGGAAG	CTGCACGCTACTTGGCTGGTTC
Pig19Fw:Pig60Rv	AGCAGCCGCGGTAATACGGAAG	GCTGCCTTCGCAATCGGAGTTC
Pig19Fw:Pig61Rv	AGCAGCCGCGGTAATACGGAAG	GATACCCGCACTTTCGAGCTTC
Pig19Fw:Pig62Rv	AGCAGCCGCGGTAATACGGAAG	AACGCTACGGTAAGCTGCCTTC
Pig19Fw:Pig63Rv	AGCAGCCGCGGTAATACGGAAG	CGCACTTTCGAGCTTCAGCGTC
Pig19Fw:Pig64Rv	AGCAGCCGCGGTAATACGGAAG	GTTTACAACCCATAGGGCCGTC
Pig19Fw:Pig65Rv	AGCAGCCGCGGTAATACGGAAG	TTGGCTGGTTCAGACTTACGTC
Pig19Fw:Pig66Rv	AGCAGCCGCGGTAATACGGAAG	CACCACGAATTCCGCCTACCTC
Pig19Fw:Pig67Rv	AGCAGCCGCGGTAATACGGAAG	AATCGGAGTTCTTCGTGATATC
Pig19Fw:Pig68Rv	AGCAGCCGCGGTAATACGGAAG	TACAACCCATAGGGCCGTCATC
Pig19Fw:Pig69Rv	AGCAGCCGCGGTAATACGGAAG	ACGGTAAGCTGCCTTCGCAATC
Pig19Fw:Pig70Rv	AGCAGCCGCGGTAATACGGAAG	TCCTTATTCATGCGGTACCTGC
Pig19Fw:Pig71Rv	AGCAGCCGCGGTAATACGGAAG	ATTAGCCGGTCCTTATTCATGC
Pig19Fw:Pig72Rv	AGCAGCCGCGGTAATACGGAAG	GTCATCCTGCACGCTACTTGGC
Pig19Fw:Pig73Rv	AGCAGCCGCGGTAATACGGAAG	AGCAGTTTACAACCCATAGGGC
Pig19Fw:Pig74Rv	AGCAGCCGCGGTAATACGGAAG	TGATATCTAAGCATTTCACCGC
Pig19Fw:Pig75Rv	AGCAGCCGCGGTAATACGGAAG	ACCCGCACTTTCGAGCTTCAGC
Pig19Fw:Pig76Rv	AGCAGCCGCGGTAATACGGAAG	GAGTTCTTCGTGATATCTAAGC
Pig19Fw:Pig77Rv	AGCAGCCGCGGTAATACGGAAG	TGGCTGGTTCAGACTTACGTCC
Pig19Fw:Pig78Rv	AGCAGCCGCGGTAATACGGAAG	ACCACGAATTCCGCCTACCTCC
Pig19Fw:Pig79Rv	AGCAGCCGCGGTAATACGGAAG	ACAACCCATAGGGCCGTCATCC
Pig19Fw:Pig80Rv	AGCAGCCGCGGTAATACGGAAG	GCAGTTTACAACCCATAGGGCC
Pig19Fw:Pig81Rv	AGCAGCCGCGGTAATACGGAAG	GGCCTACGCTCCCTTTAAACCC
Pig19Fw:Pig82Rv	AGCAGCCGCGGTAATACGGAAG	TACACCACGAATTCCGCCTACC
Pig19Fw:Pig83Rv	AGCAGCCGCGGTAATACGGAAG	TTCAGACTTACGTCCATTGACC
Pig19Fw:Pig84Rv	AGCAGCCGCGGTAATACGGAAG	CGGCCTACGCTCCCTTTAAACC
Pig19Fw:Pig85Rv	AGCAGCCGCGGTAATACGGAAG	TATCTAAGCATTTCACCGCTAC
Pig19Fw:Pig86Rv	AGCAGCCGCGGTAATACGGAAG	GTTCAGACTTACGTCCATTGAC
Pig19Fw:Pig87Rv	AGCAGCCGCGGTAATACGGAAG	ACGCTACTTGGCTGGTTCAGAC
Pig19Fw:Pig88Rv	AGCAGCCGCGGTAATACGGAAG	TCTAAGCATTTCACCGCTACAC
Pig19Fw:Pig89Rv	AGCAGCCGCGGTAATACGGAAG	CCGGCCTACGCTCCCTTTAAAC
Pig19Fw:Pig90Rv	AGCAGCCGCGGTAATACGGAAG	AAGCCGGCCTACGCTCCCTTTA
Pig19Fw:Pig91Rv	AGCAGCCGCGGTAATACGGAAG	GCGGCATTTCACAACACGCTTA
Pig19Fw:Pig92Rv	AGCAGCCGCGGTAATACGGAAG	GCACGGAATTAGCCGGTCCTTA
Pig19Fw:Pig93Rv	AGCAGCCGCGGTAATACGGAAG	TCGGAGTTCTTCGTGATATCTA
Pig19Fw:Pig94Rv	AGCAGCCGCGGTAATACGGAAG	GCTACACCACGAATTCCGCCTA
Pig19Fw:Pig95Rv	AGCAGCCGCGGTAATACGGAAG	GCAATCGGAGTTCTTCGTGATA
Pig19Fw:Pig96Rv	AGCAGCCGCGGTAATACGGAAG	TACGCTCCCTTTAAACCCAATA
Pig19Fw:Pig97Rv	AGCAGCCGCGGTAATACGGAAG	GGTTCAGACTTACGTCCATTGA
Pig19Fw:Pig98Rv	AGCAGCCGCGGTAATACGGAAG	TCGCAATCGGAGTTCTTCGTGA
Pig19Fw:Pig99Rv	AGCAGCCGCGGTAATACGGAAG	GTAAGCTGCCTTCGCAATCGGA
Pig19Fw:Pig100Rv	AGCAGCCGCGGTAATACGGAAG	CACGCTACTTGGCTGGTTCAGA
Pig19Fw:Pig101Rv	AGCAGCCGCGGTAATACGGAAG	TGCACGCTACTTGGCTGGTTCA
Pig19Fw:Pig102Rv	AGCAGCCGCGGTAATACGGAAG	ATACCCGCACTTTCGAGCTTCA
Pig19Fw:Pig103Rv	AGCAGCCGCGGTAATACGGAAG	GCACTTTCGAGCTTCAGCGTCA
Pig19Fw:Pig104Rv	AGCAGCCGCGGTAATACGGAAG	TTTACAACCCATAGGGCCGTCA
Pig19Fw:Pig105Rv	AGCAGCCGCGGTAATACGGAAG	CCTTATTCATGCGGTACCTGCA
Pig19Fw:Pig106Rv	AGCAGCCGCGGTAATACGGAAG	GCTACGGTAAGCTGCCTTCGCA
Pig19Fw:Pig107Rv	AGCAGCCGCGGTAATACGGAAG	GGCTGGTTCAGACTTACGTCCA
Pig19Fw:Pig108Rv	AGCAGCCGCGGTAATACGGAAG	GCCTACGCTCCCTTTAAACCCA
Pig19Fw:Pig109Rv	AGCAGCCGCGGTAATACGGAAG	TCAGACTTACGTCCATTGACCA
Pig19Fw:Pig110Rv	AGCAGCCGCGGTAATACGGAAG	ATCTAAGCATTTCACCGCTACA
Pig19Fw:Pig111Rv	AGCAGCCGCGGTAATACGGAAG	AGCCGGCCTACGCTCCCTTTAA
Pig19Fw:Pig112Rv	AGCAGCCGCGGTAATACGGAAG	CGGCATTTCACAACACGCTTAA
Pig19Fw:Pig113Rv	AGCAGCCGCGGTAATACGGAAG	CGGAGTTCTTCGTGATATCTAA
Pig19Fw:Pig114Rv	AGCAGCCGCGGTAATACGGAAG	ACGCTCCCTTTAAACCCAATAA
Pig19Fw:Pig115Rv	AGCAGCCGCGGTAATACGGAAG	CTTATTCATGCGGTACCTGCAA
Pig19Fw:Pig116Rv	AGCAGCCGCGGTAATACGGAAG	CTACGGTAAGCTGCCTTCGCAA
Pig19Fw:Pig117Rv	AGCAGCCGCGGTAATACGGAAG	CCTACGCTCCCTTTAAACCCAA
Pig19Fw:Pig118Rv	AGCAGCCGCGGTAATACGGAAG	CAGACTTACGTCCATTGACCAA
Pig19Fw:Pig119Rv	AGCAGCCGCGGTAATACGGAAG	GCCGGCCTACGCTCCCTTTAAA
Pig19Fw:Pig120Rv	AGCAGCCGCGGTAATACGGAAG	GGCATTTCACAACACGCTTAAA
Pig19Fw:Pig121Rv	AGCAGCCGCGGTAATACGGAAG	TTATTCATGCGGTACCTGCAAA
Pig20Fw:Pig1Rv	AGCCAAGTAGCGTGCAGGATGA	CCTGCACGCTACTTGGCTGGTT
Pig20Fw:Pig2Rv	AGCCAAGTAGCGTGCAGGATGA	AGCTGCCTTCGCAATCGGAGTT
Pig20Fw:Pig3Rv	AGCCAAGTAGCGTGCAGGATGA	TGCCTTCGCAATCGGAGTTCTT
Pig20Fw:Pig4Rv	AGCCAAGTAGCGTGCAGGATGA	CGCGGCATTTCACAACACGCTT
Pig20Fw:Pig5Rv	AGCCAAGTAGCGTGCAGGATGA	CGATACCCGCACTTTCGAGCTT
Pig20Fw:Pig6Rv	AGCCAAGTAGCGTGCAGGATGA	GGCACGGAATTAGCCGGTCCTT
Pig20Fw:Pig7Rv	AGCCAAGTAGCGTGCAGGATGA	TAACGCTACGGTAAGCTGCCTT
Pig20Fw:Pig8Rv	AGCCAAGTAGCGTGCAGGATGA	GCCGTCATCCTGCACGCTACTT
Pig20Fw:Pig9Rv	AGCCAAGTAGCGTGCAGGATGA	ACGGAATTAGCCGGTCCTTATT
Pig20Fw:Pig10Rv	AGCCAAGTAGCGTGCAGGATGA	CTGGTTCAGACTTACGTCCATT
Pig20Fw:Pig11Rv	AGCCAAGTAGCGTGCAGGATGA	TCCTGCACGCTACTTGGCTGGT
Pig20Fw:Pig12Rv	AGCCAAGTAGCGTGCAGGATGA	TGCTGGCACGGAATTAGCCGGT
Pig20Fw:Pig13Rv	AGCCAAGTAGCGTGCAGGATGA	CCGCACTTTCGAGCTTCAGCGT
Pig20Fw:Pig14Rv	AGCCAAGTAGCGTGCAGGATGA	AGTTTACAACCCATAGGGCCGT
Pig20Fw:Pig15Rv	AGCCAAGTAGCGTGCAGGATGA	CTTGGCTGGTTCAGACTTACGT
Pig20Fw:Pig16Rv	AGCCAAGTAGCGTGCAGGATGA	AAGCTGCCTTCGCAATCGGAGT
Pig20Fw:Pig17Rv	AGCCAAGTAGCGTGCAGGATGA	CTGCCTTCGCAATCGGAGTTCT
Pig20Fw:Pig18Rv	AGCCAAGTAGCGTGCAGGATGA	ATCGGAGTTCTTCGTGATATCT
Pig20Fw:Pig19Rv	AGCCAAGTAGCGTGCAGGATGA	CTTCCGTATTACCGCGGCTGCT
Pig20Fw:Pig20Rv	AGCCAAGTAGCGTGCAGGATGA	TCATCCTGCACGCTACTTGGCT
Pig20Fw:Pig21Rv	AGCCAAGTAGCGTGCAGGATGA	GACCTTCCGTATTACCGCGGCT
Pig20Fw:Pig22Rv	AGCCAAGTAGCGTGCAGGATGA	GATATCTAAGCATTTCACCGCT
Pig20Fw:Pig23Rv	AGCCAAGTAGCGTGCAGGATGA	CCGCGGCATTTCACAACACGCT
Pig20Fw:Pig24Rv	AGCCAAGTAGCGTGCAGGATGA	TGGCACGGAATTAGCCGGTCCT
Pig20Fw:Pig25Rv	AGCCAAGTAGCGTGCAGGATGA	CAACCCATAGGGCCGTCATCCT
Pig20Fw:Pig26Rv	AGCCAAGTAGCGTGCAGGATGA	CGCTACACCACGAATTCCGCCT
Pig20Fw:Pig27Rv	AGCCAAGTAGCGTGCAGGATGA	GGTCCTTATTCATGCGGTACCT
Pig20Fw:Pig28Rv	AGCCAAGTAGCGTGCAGGATGA	ACACCACGAATTCCGCCTACCT
Pig20Fw:Pig29Rv	AGCCAAGTAGCGTGCAGGATGA	CGCTACTTGGCTGGTTCAGACT
Pig20Fw:Pig30Rv	AGCCAAGTAGCGTGCAGGATGA	CACGGAATTAGCCGGTCCTTAT
Pig20Fw:Pig31Rv	AGCCAAGTAGCGTGCAGGATGA	CAATCGGAGTTCTTCGTGATAT
Pig20Fw:Pig32Rv	AGCCAAGTAGCGTGCAGGATGA	CGCAATCGGAGTTCTTCGTGAT
Pig20Fw:Pig33Rv	AGCCAAGTAGCGTGCAGGATGA	TTACAACCCATAGGGCCGTCAT
Pig20Fw:Pig34Rv	AGCCAAGTAGCGTGCAGGATGA	GCTGGTTCAGACTTACGTCCAT
Pig20Fw:Pig35Rv	AGCCAAGTAGCGTGCAGGATGA	TACGGTAAGCTGCCTTCGCAAT
Pig20Fw:Pig36Rv	AGCCAAGTAGCGTGCAGGATGA	CTACGCTCCCTTTAAACCCAAT
Pig20Fw:Pig37Rv	AGCCAAGTAGCGTGCAGGATGA	CCGTCATCCTGCACGCTACTTG
Pig20Fw:Pig38Rv	AGCCAAGTAGCGTGCAGGATGA	TGGTTCAGACTTACGTCCATTG
Pig20Fw:Pig39Rv	AGCCAAGTAGCGTGCAGGATGA	TTCCGTATTACCGCGGCTGCTG
Pig20Fw:Pig40Rv	AGCCAAGTAGCGTGCAGGATGA	CATCCTGCACGCTACTTGGCTG
Pig20Fw:Pig41Rv	AGCCAAGTAGCGTGCAGGATGA	ACCTTCCGTATTACCGCGGCTG
Pig20Fw:Pig42Rv	AGCCAAGTAGCGTGCAGGATGA	AACCCATAGGGCCGTCATCCTG
Pig20Fw:Pig43Rv	AGCCAAGTAGCGTGCAGGATGA	GTCCTTATTCATGCGGTACCTG
Pig20Fw:Pig44Rv	AGCCAAGTAGCGTGCAGGATGA	AATTAGCCGGTCCTTATTCATG
Pig20Fw:Pig45Rv	AGCCAAGTAGCGTGCAGGATGA	CGTCATCCTGCACGCTACTTGG
Pig20Fw:Pig46Rv	AGCCAAGTAGCGTGCAGGATGA	ATCCTGCACGCTACTTGGCTGG
Pig20Fw:Pig47Rv	AGCCAAGTAGCGTGCAGGATGA	AAGCAGTTTACAACCCATAGGG
Pig20Fw:Pig48Rv	AGCCAAGTAGCGTGCAGGATGA	GGTAAGCTGCCTTCGCAATCGG
Pig20Fw:Pig49Rv	AGCCAAGTAGCGTGCAGGATGA	TAGCCGGTCCTTATTCATGCGG
Pig20Fw:Pig50Rv	AGCCAAGTAGCGTGCAGGATGA	AAAGCAGTTTACAACCCATAGG
Pig20Fw:Pig51Rv	AGCCAAGTAGCGTGCAGGATGA	ACGCTACGGTAAGCTGCCTTCG
Pig20Fw:Pig52Rv	AGCCAAGTAGCGTGCAGGATGA	CGGTAAGCTGCCTTCGCAATCG
Pig20Fw:Pig53Rv	AGCCAAGTAGCGTGCAGGATGA	TTAGCCGGTCCTTATTCATGCG
Pig20Fw:Pig54Rv	AGCCAAGTAGCGTGCAGGATGA	CAGTTTACAACCCATAGGGCCG
Pig20Fw:Pig55Rv	AGCCAAGTAGCGTGCAGGATGA	TAAGCTGCCTTCGCAATCGGAG
Pig20Fw:Pig56Rv	AGCCAAGTAGCGTGCAGGATGA	GCACGCTACTTGGCTGGTTCAG
Pig20Fw:Pig57Rv	AGCCAAGTAGCGTGCAGGATGA	TACCCGCACTTTCGAGCTTCAG
Pig20Fw:Pig58Rv	AGCCAAGTAGCGTGCAGGATGA	GGAGTTCTTCGTGATATCTAAG
Pig20Fw:Pig59Rv	AGCCAAGTAGCGTGCAGGATGA	CTGCACGCTACTTGGCTGGTTC
Pig20Fw:Pig60Rv	AGCCAAGTAGCGTGCAGGATGA	GCTGCCTTCGCAATCGGAGTTC
Pig20Fw:Pig61Rv	AGCCAAGTAGCGTGCAGGATGA	GATACCCGCACTTTCGAGCTTC
Pig20Fw:Pig62Rv	AGCCAAGTAGCGTGCAGGATGA	AACGCTACGGTAAGCTGCCTTC
Pig20Fw:Pig63Rv	AGCCAAGTAGCGTGCAGGATGA	CGCACTTTCGAGCTTCAGCGTC
Pig20Fw:Pig64Rv	AGCCAAGTAGCGTGCAGGATGA	GTTTACAACCCATAGGGCCGTC
Pig20Fw:Pig65Rv	AGCCAAGTAGCGTGCAGGATGA	TTGGCTGGTTCAGACTTACGTC
Pig20Fw:Pig66Rv	AGCCAAGTAGCGTGCAGGATGA	CACCACGAATTCCGCCTACCTC
Pig20Fw:Pig67Rv	AGCCAAGTAGCGTGCAGGATGA	AATCGGAGTTCTTCGTGATATC
Pig20Fw:Pig68Rv	AGCCAAGTAGCGTGCAGGATGA	TACAACCCATAGGGCCGTCATC
Pig20Fw:Pig69Rv	AGCCAAGTAGCGTGCAGGATGA	ACGGTAAGCTGCCTTCGCAATC
Pig20Fw:Pig70Rv	AGCCAAGTAGCGTGCAGGATGA	TCCTTATTCATGCGGTACCTGC
Pig20Fw:Pig71Rv	AGCCAAGTAGCGTGCAGGATGA	ATTAGCCGGTCCTTATTCATGC
Pig20Fw:Pig72Rv	AGCCAAGTAGCGTGCAGGATGA	GTCATCCTGCACGCTACTTGGC
Pig20Fw:Pig73Rv	AGCCAAGTAGCGTGCAGGATGA	AGCAGTTTACAACCCATAGGGC
Pig20Fw:Pig74Rv	AGCCAAGTAGCGTGCAGGATGA	TGATATCTAAGCATTTCACCGC
Pig20Fw:Pig75Rv	AGCCAAGTAGCGTGCAGGATGA	ACCCGCACTTTCGAGCTTCAGC
Pig20Fw:Pig76Rv	AGCCAAGTAGCGTGCAGGATGA	GAGTTCTTCGTGATATCTAAGC
Pig20Fw:Pig77Rv	AGCCAAGTAGCGTGCAGGATGA	TGGCTGGTTCAGACTTACGTCC
Pig20Fw:Pig78Rv	AGCCAAGTAGCGTGCAGGATGA	ACCACGAATTCCGCCTACCTCC
Pig20Fw:Pig79Rv	AGCCAAGTAGCGTGCAGGATGA	ACAACCCATAGGGCCGTCATCC
Pig20Fw:Pig80Rv	AGCCAAGTAGCGTGCAGGATGA	GCAGTTTACAACCCATAGGGCC
Pig20Fw:Pig81Rv	AGCCAAGTAGCGTGCAGGATGA	GGCCTACGCTCCCTTTAAACCC
Pig20Fw:Pig82Rv	AGCCAAGTAGCGTGCAGGATGA	TACACCACGAATTCCGCCTACC
Pig20Fw:Pig83Rv	AGCCAAGTAGCGTGCAGGATGA	TTCAGACTTACGTCCATTGACC
Pig20Fw:Pig84Rv	AGCCAAGTAGCGTGCAGGATGA	CGGCCTACGCTCCCTTTAAACC
Pig20Fw:Pig85Rv	AGCCAAGTAGCGTGCAGGATGA	TATCTAAGCATTTCACCGCTAC
Pig20Fw:Pig86Rv	AGCCAAGTAGCGTGCAGGATGA	GTTCAGACTTACGTCCATTGAC
Pig20Fw:Pig87Rv	AGCCAAGTAGCGTGCAGGATGA	ACGCTACTTGGCTGGTTCAGAC
Pig20Fw:Pig88Rv	AGCCAAGTAGCGTGCAGGATGA	TCTAAGCATTTCACCGCTACAC
Pig20Fw:Pig89Rv	AGCCAAGTAGCGTGCAGGATGA	CCGGCCTACGCTCCCTTTAAAC
Pig20Fw:Pig90Rv	AGCCAAGTAGCGTGCAGGATGA	AAGCCGGCCTACGCTCCCTTTA
Pig20Fw:Pig91Rv	AGCCAAGTAGCGTGCAGGATGA	GCGGCATTTCACAACACGCTTA
Pig20Fw:Pig92Rv	AGCCAAGTAGCGTGCAGGATGA	GCACGGAATTAGCCGGTCCTTA
Pig20Fw:Pig93Rv	AGCCAAGTAGCGTGCAGGATGA	TCGGAGTTCTTCGTGATATCTA
Pig20Fw:Pig94Rv	AGCCAAGTAGCGTGCAGGATGA	GCTACACCACGAATTCCGCCTA
Pig20Fw:Pig95Rv	AGCCAAGTAGCGTGCAGGATGA	GCAATCGGAGTTCTTCGTGATA
Pig20Fw:Pig96Rv	AGCCAAGTAGCGTGCAGGATGA	TACGCTCCCTTTAAACCCAATA
Pig20Fw:Pig97Rv	AGCCAAGTAGCGTGCAGGATGA	GGTTCAGACTTACGTCCATTGA
Pig20Fw:Pig98Rv	AGCCAAGTAGCGTGCAGGATGA	TCGCAATCGGAGTTCTTCGTGA
Pig20Fw:Pig99Rv	AGCCAAGTAGCGTGCAGGATGA	GTAAGCTGCCTTCGCAATCGGA
Pig20Fw:Pig100Rv	AGCCAAGTAGCGTGCAGGATGA	CACGCTACTTGGCTGGTTCAGA
Pig20Fw:Pig101Rv	AGCCAAGTAGCGTGCAGGATGA	TGCACGCTACTTGGCTGGTTCA
Pig20Fw:Pig102Rv	AGCCAAGTAGCGTGCAGGATGA	ATACCCGCACTTTCGAGCTTCA
Pig20Fw:Pig103Rv	AGCCAAGTAGCGTGCAGGATGA	GCACTTTCGAGCTTCAGCGTCA
Pig20Fw:Pig104Rv	AGCCAAGTAGCGTGCAGGATGA	TTTACAACCCATAGGGCCGTCA
Pig20Fw:Pig105Rv	AGCCAAGTAGCGTGCAGGATGA	CCTTATTCATGCGGTACCTGCA
Pig20Fw:Pig106Rv	AGCCAAGTAGCGTGCAGGATGA	GCTACGGTAAGCTGCCTTCGCA
Pig20Fw:Pig107Rv	AGCCAAGTAGCGTGCAGGATGA	GGCTGGTTCAGACTTACGTCCA
Pig20Fw:Pig108Rv	AGCCAAGTAGCGTGCAGGATGA	GCCTACGCTCCCTTTAAACCCA
Pig20Fw:Pig109Rv	AGCCAAGTAGCGTGCAGGATGA	TCAGACTTACGTCCATTGACCA
Pig20Fw:Pig110Rv	AGCCAAGTAGCGTGCAGGATGA	ATCTAAGCATTTCACCGCTACA
Pig20Fw:Pig111Rv	AGCCAAGTAGCGTGCAGGATGA	AGCCGGCCTACGCTCCCTTTAA
Pig20Fw:Pig112Rv	AGCCAAGTAGCGTGCAGGATGA	CGGCATTTCACAACACGCTTAA
Pig20Fw:Pig113Rv	AGCCAAGTAGCGTGCAGGATGA	CGGAGTTCTTCGTGATATCTAA
Pig20Fw:Pig114Rv	AGCCAAGTAGCGTGCAGGATGA	ACGCTCCCTTTAAACCCAATAA
Pig20Fw:Pig115Rv	AGCCAAGTAGCGTGCAGGATGA	CTTATTCATGCGGTACCTGCAA
Pig20Fw:Pig116Rv	AGCCAAGTAGCGTGCAGGATGA	CTACGGTAAGCTGCCTTCGCAA
Pig20Fw:Pig117Rv	AGCCAAGTAGCGTGCAGGATGA	CCTACGCTCCCTTTAAACCCAA
Pig20Fw:Pig118Rv	AGCCAAGTAGCGTGCAGGATGA	CAGACTTACGTCCATTGACCAA
Pig20Fw:Pig119Rv	AGCCAAGTAGCGTGCAGGATGA	GCCGGCCTACGCTCCCTTTAAA
Pig20Fw:Pig120Rv	AGCCAAGTAGCGTGCAGGATGA	GGCATTTCACAACACGCTTAAA
Pig20Fw:Pig121Rv	AGCCAAGTAGCGTGCAGGATGA	TTATTCATGCGGTACCTGCAAA
Pig21Fw:Pig1Rv	AGCCGCGGTAATACGGAAGGTC	CCTGCACGCTACTTGGCTGGTT
Pig21Fw:Pig2Rv	AGCCGCGGTAATACGGAAGGTC	AGCTGCCTTCGCAATCGGAGTT
Pig21Fw:Pig3Rv	AGCCGCGGTAATACGGAAGGTC	TGCCTTCGCAATCGGAGTTCTT
Pig21Fw:Pig4Rv	AGCCGCGGTAATACGGAAGGTC	CGCGGCATTTCACAACACGCTT
Pig21Fw:Pig5Rv	AGCCGCGGTAATACGGAAGGTC	CGATACCCGCACTTTCGAGCTT
Pig21Fw:Pig6Rv	AGCCGCGGTAATACGGAAGGTC	GGCACGGAATTAGCCGGTCCTT
Pig21Fw:Pig7Rv	AGCCGCGGTAATACGGAAGGTC	TAACGCTACGGTAAGCTGCCTT
Pig21Fw:Pig8Rv	AGCCGCGGTAATACGGAAGGTC	GCCGTCATCCTGCACGCTACTT
Pig21Fw:Pig9Rv	AGCCGCGGTAATACGGAAGGTC	ACGGAATTAGCCGGTCCTTATT
Pig21Fw:Pig10Rv	AGCCGCGGTAATACGGAAGGTC	CTGGTTCAGACTTACGTCCATT
Pig21Fw:Pig11Rv	AGCCGCGGTAATACGGAAGGTC	TCCTGCACGCTACTTGGCTGGT
Pig21Fw:Pig12Rv	AGCCGCGGTAATACGGAAGGTC	TGCTGGCACGGAATTAGCCGGT
Pig21Fw:Pig13Rv	AGCCGCGGTAATACGGAAGGTC	CCGCACTTTCGAGCTTCAGCGT
Pig21Fw:Pig14Rv	AGCCGCGGTAATACGGAAGGTC	AGTTTACAACCCATAGGGCCGT
Pig21Fw:Pig15Rv	AGCCGCGGTAATACGGAAGGTC	CTTGGCTGGTTCAGACTTACGT
Pig21Fw:Pig16Rv	AGCCGCGGTAATACGGAAGGTC	AAGCTGCCTTCGCAATCGGAGT
Pig21Fw:Pig17Rv	AGCCGCGGTAATACGGAAGGTC	CTGCCTTCGCAATCGGAGTTCT
Pig21Fw:Pig18Rv	AGCCGCGGTAATACGGAAGGTC	ATCGGAGTTCTTCGTGATATCT
Pig21Fw:Pig19Rv	AGCCGCGGTAATACGGAAGGTC	CTTCCGTATTACCGCGGCTGCT
Pig21Fw:Pig20Rv	AGCCGCGGTAATACGGAAGGTC	TCATCCTGCACGCTACTTGGCT
Pig21Fw:Pig21Rv	AGCCGCGGTAATACGGAAGGTC	GACCTTCCGTATTACCGCGGCT
Pig21Fw:Pig22Rv	AGCCGCGGTAATACGGAAGGTC	GATATCTAAGCATTTCACCGCT
Pig21Fw:Pig23Rv	AGCCGCGGTAATACGGAAGGTC	CCGCGGCATTTCACAACACGCT
Pig21Fw:Pig24Rv	AGCCGCGGTAATACGGAAGGTC	TGGCACGGAATTAGCCGGTCCT
Pig21Fw:Pig25Rv	AGCCGCGGTAATACGGAAGGTC	CAACCCATAGGGCCGTCATCCT
Pig21Fw:Pig26Rv	AGCCGCGGTAATACGGAAGGTC	CGCTACACCACGAATTCCGCCT
Pig21Fw:Pig27Rv	AGCCGCGGTAATACGGAAGGTC	GGTCCTTATTCATGCGGTACCT
Pig21Fw:Pig28Rv	AGCCGCGGTAATACGGAAGGTC	ACACCACGAATTCCGCCTACCT
Pig21Fw:Pig29Rv	AGCCGCGGTAATACGGAAGGTC	CGCTACTTGGCTGGTTCAGACT
Pig21Fw:Pig30Rv	AGCCGCGGTAATACGGAAGGTC	CACGGAATTAGCCGGTCCTTAT
Pig21Fw:Pig31Rv	AGCCGCGGTAATACGGAAGGTC	CAATCGGAGTTCTTCGTGATAT
Pig21Fw:Pig32Rv	AGCCGCGGTAATACGGAAGGTC	CGCAATCGGAGTTCTTCGTGAT
Pig21Fw:Pig33Rv	AGCCGCGGTAATACGGAAGGTC	TTACAACCCATAGGGCCGTCAT
Pig21Fw:Pig34Rv	AGCCGCGGTAATACGGAAGGTC	GCTGGTTCAGACTTACGTCCAT
Pig21Fw:Pig35Rv	AGCCGCGGTAATACGGAAGGTC	TACGGTAAGCTGCCTTCGCAAT
Pig21Fw:Pig36Rv	AGCCGCGGTAATACGGAAGGTC	CTACGCTCCCTTTAAACCCAAT
Pig21Fw:Pig37Rv	AGCCGCGGTAATACGGAAGGTC	CCGTCATCCTGCACGCTACTTG
Pig21Fw:Pig38Rv	AGCCGCGGTAATACGGAAGGTC	TGGTTCAGACTTACGTCCATTG
Pig21Fw:Pig39Rv	AGCCGCGGTAATACGGAAGGTC	TTCCGTATTACCGCGGCTGCTG
Pig21Fw:Pig40Rv	AGCCGCGGTAATACGGAAGGTC	CATCCTGCACGCTACTTGGCTG
Pig21Fw:Pig41Rv	AGCCGCGGTAATACGGAAGGTC	ACCTTCCGTATTACCGCGGCTG
Pig21Fw:Pig42Rv	AGCCGCGGTAATACGGAAGGTC	AACCCATAGGGCCGTCATCCTG
Pig21Fw:Pig43Rv	AGCCGCGGTAATACGGAAGGTC	GTCCTTATTCATGCGGTACCTG
Pig21Fw:Pig44Rv	AGCCGCGGTAATACGGAAGGTC	AATTAGCCGGTCCTTATTCATG
Pig21Fw:Pig45Rv	AGCCGCGGTAATACGGAAGGTC	CGTCATCCTGCACGCTACTTGG
Pig21Fw:Pig46Rv	AGCCGCGGTAATACGGAAGGTC	ATCCTGCACGCTACTTGGCTGG
Pig21Fw:Pig47Rv	AGCCGCGGTAATACGGAAGGTC	AAGCAGTTTACAACCCATAGGG
Pig21Fw:Pig48Rv	AGCCGCGGTAATACGGAAGGTC	GGTAAGCTGCCTTCGCAATCGG
Pig21Fw:Pig49Rv	AGCCGCGGTAATACGGAAGGTC	TAGCCGGTCCTTATTCATGCGG
Pig21Fw:Pig50Rv	AGCCGCGGTAATACGGAAGGTC	AAAGCAGTTTACAACCCATAGG
Pig21Fw:Pig51Rv	AGCCGCGGTAATACGGAAGGTC	ACGCTACGGTAAGCTGCCTTCG
Pig21Fw:Pig52Rv	AGCCGCGGTAATACGGAAGGTC	CGGTAAGCTGCCTTCGCAATCG
Pig21Fw:Pig53Rv	AGCCGCGGTAATACGGAAGGTC	TTAGCCGGTCCTTATTCATGCG
Pig21Fw:Pig54Rv	AGCCGCGGTAATACGGAAGGTC	CAGTTTACAACCCATAGGGCCG
Pig21Fw:Pig55Rv	AGCCGCGGTAATACGGAAGGTC	TAAGCTGCCTTCGCAATCGGAG
Pig21Fw:Pig56Rv	AGCCGCGGTAATACGGAAGGTC	GCACGCTACTTGGCTGGTTCAG
Pig21Fw:Pig57Rv	AGCCGCGGTAATACGGAAGGTC	TACCCGCACTTTCGAGCTTCAG
Pig21Fw:Pig58Rv	AGCCGCGGTAATACGGAAGGTC	GGAGTTCTTCGTGATATCTAAG
Pig21Fw:Pig59Rv	AGCCGCGGTAATACGGAAGGTC	CTGCACGCTACTTGGCTGGTTC
Pig21Fw:Pig60Rv	AGCCGCGGTAATACGGAAGGTC	GCTGCCTTCGCAATCGGAGTTC
Pig21Fw:Pig61Rv	AGCCGCGGTAATACGGAAGGTC	GATACCCGCACTTTCGAGCTTC
Pig21Fw:Pig62Rv	AGCCGCGGTAATACGGAAGGTC	AACGCTACGGTAAGCTGCCTTC
Pig21Fw:Pig63Rv	AGCCGCGGTAATACGGAAGGTC	CGCACTTTCGAGCTTCAGCGTC
Pig21Fw:Pig64Rv	AGCCGCGGTAATACGGAAGGTC	GTTTACAACCCATAGGGCCGTC
Pig21Fw:Pig65Rv	AGCCGCGGTAATACGGAAGGTC	TTGGCTGGTTCAGACTTACGTC
Pig21Fw:Pig66Rv	AGCCGCGGTAATACGGAAGGTC	CACCACGAATTCCGCCTACCTC
Pig21Fw:Pig67Rv	AGCCGCGGTAATACGGAAGGTC	AATCGGAGTTCTTCGTGATATC
Pig21Fw:Pig68Rv	AGCCGCGGTAATACGGAAGGTC	TACAACCCATAGGGCCGTCATC
Pig21Fw:Pig69Rv	AGCCGCGGTAATACGGAAGGTC	ACGGTAAGCTGCCTTCGCAATC
Pig21Fw:Pig70Rv	AGCCGCGGTAATACGGAAGGTC	TCCTTATTCATGCGGTACCTGC
Pig21Fw:Pig71Rv	AGCCGCGGTAATACGGAAGGTC	ATTAGCCGGTCCTTATTCATGC
Pig21Fw:Pig72Rv	AGCCGCGGTAATACGGAAGGTC	GTCATCCTGCACGCTACTTGGC
Pig21Fw:Pig73Rv	AGCCGCGGTAATACGGAAGGTC	AGCAGTTTACAACCCATAGGGC
Pig21Fw:Pig74Rv	AGCCGCGGTAATACGGAAGGTC	TGATATCTAAGCATTTCACCGC
Pig21Fw:Pig75Rv	AGCCGCGGTAATACGGAAGGTC	ACCCGCACTTTCGAGCTTCAGC
Pig21Fw:Pig76Rv	AGCCGCGGTAATACGGAAGGTC	GAGTTCTTCGTGATATCTAAGC
Pig21Fw:Pig77Rv	AGCCGCGGTAATACGGAAGGTC	TGGCTGGTTCAGACTTACGTCC
Pig21Fw:Pig78Rv	AGCCGCGGTAATACGGAAGGTC	ACCACGAATTCCGCCTACCTCC
Pig21Fw:Pig79Rv	AGCCGCGGTAATACGGAAGGTC	ACAACCCATAGGGCCGTCATCC
Pig21Fw:Pig80Rv	AGCCGCGGTAATACGGAAGGTC	GCAGTTTACAACCCATAGGGCC
Pig21Fw:Pig81Rv	AGCCGCGGTAATACGGAAGGTC	GGCCTACGCTCCCTTTAAACCC
Pig21Fw:Pig82Rv	AGCCGCGGTAATACGGAAGGTC	TACACCACGAATTCCGCCTACC
Pig21Fw:Pig83Rv	AGCCGCGGTAATACGGAAGGTC	TTCAGACTTACGTCCATTGACC
Pig21Fw:Pig84Rv	AGCCGCGGTAATACGGAAGGTC	CGGCCTACGCTCCCTTTAAACC
Pig21Fw:Pig85Rv	AGCCGCGGTAATACGGAAGGTC	TATCTAAGCATTTCACCGCTAC
Pig21Fw:Pig86Rv	AGCCGCGGTAATACGGAAGGTC	GTTCAGACTTACGTCCATTGAC
Pig21Fw:Pig87Rv	AGCCGCGGTAATACGGAAGGTC	ACGCTACTTGGCTGGTTCAGAC
Pig21Fw:Pig88Rv	AGCCGCGGTAATACGGAAGGTC	TCTAAGCATTTCACCGCTACAC
Pig21Fw:Pig89Rv	AGCCGCGGTAATACGGAAGGTC	CCGGCCTACGCTCCCTTTAAAC
Pig21Fw:Pig90Rv	AGCCGCGGTAATACGGAAGGTC	AAGCCGGCCTACGCTCCCTTTA
Pig21Fw:Pig91Rv	AGCCGCGGTAATACGGAAGGTC	GCGGCATTTCACAACACGCTTA
Pig21Fw:Pig92Rv	AGCCGCGGTAATACGGAAGGTC	GCACGGAATTAGCCGGTCCTTA
Pig21Fw:Pig93Rv	AGCCGCGGTAATACGGAAGGTC	TCGGAGTTCTTCGTGATATCTA
Pig21Fw:Pig94Rv	AGCCGCGGTAATACGGAAGGTC	GCTACACCACGAATTCCGCCTA
Pig21Fw:Pig95Rv	AGCCGCGGTAATACGGAAGGTC	GCAATCGGAGTTCTTCGTGATA
Pig21Fw:Pig96Rv	AGCCGCGGTAATACGGAAGGTC	TACGCTCCCTTTAAACCCAATA
Pig21Fw:Pig97Rv	AGCCGCGGTAATACGGAAGGTC	GGTTCAGACTTACGTCCATTGA
Pig21Fw:Pig98Rv	AGCCGCGGTAATACGGAAGGTC	TCGCAATCGGAGTTCTTCGTGA
Pig21Fw:Pig99Rv	AGCCGCGGTAATACGGAAGGTC	GTAAGCTGCCTTCGCAATCGGA
Pig21Fw:Pig100Rv	AGCCGCGGTAATACGGAAGGTC	CACGCTACTTGGCTGGTTCAGA
Pig21Fw:Pig101Rv	AGCCGCGGTAATACGGAAGGTC	TGCACGCTACTTGGCTGGTTCA
Pig21Fw:Pig102Rv	AGCCGCGGTAATACGGAAGGTC	ATACCCGCACTTTCGAGCTTCA
Pig21Fw:Pig103Rv	AGCCGCGGTAATACGGAAGGTC	GCACTTTCGAGCTTCAGCGTCA
Pig21Fw:Pig104Rv	AGCCGCGGTAATACGGAAGGTC	TTTACAACCCATAGGGCCGTCA
Pig21Fw:Pig105Rv	AGCCGCGGTAATACGGAAGGTC	CCTTATTCATGCGGTACCTGCA
Pig21Fw:Pig106Rv	AGCCGCGGTAATACGGAAGGTC	GCTACGGTAAGCTGCCTTCGCA
Pig21Fw:Pig107Rv	AGCCGCGGTAATACGGAAGGTC	GGCTGGTTCAGACTTACGTCCA
Pig21Fw:Pig108Rv	AGCCGCGGTAATACGGAAGGTC	GCCTACGCTCCCTTTAAACCCA
Pig21Fw:Pig109Rv	AGCCGCGGTAATACGGAAGGTC	TCAGACTTACGTCCATTGACCA
Pig21Fw:Pig110Rv	AGCCGCGGTAATACGGAAGGTC	ATCTAAGCATTTCACCGCTACA
Pig21Fw:Pig111Rv	AGCCGCGGTAATACGGAAGGTC	AGCCGGCCTACGCTCCCTTTAA
Pig21Fw:Pig112Rv	AGCCGCGGTAATACGGAAGGTC	CGGCATTTCACAACACGCTTAA
Pig21Fw:Pig113Rv	AGCCGCGGTAATACGGAAGGTC	CGGAGTTCTTCGTGATATCTAA
Pig21Fw:Pig114Rv	AGCCGCGGTAATACGGAAGGTC	ACGCTCCCTTTAAACCCAATAA
Pig21Fw:Pig115Rv	AGCCGCGGTAATACGGAAGGTC	CTTATTCATGCGGTACCTGCAA
Pig21Fw:Pig116Rv	AGCCGCGGTAATACGGAAGGTC	CTACGGTAAGCTGCCTTCGCAA
Pig21Fw:Pig117Rv	AGCCGCGGTAATACGGAAGGTC	CCTACGCTCCCTTTAAACCCAA
Pig21Fw:Pig118Rv	AGCCGCGGTAATACGGAAGGTC	CAGACTTACGTCCATTGACCAA
Pig21Fw:Pig119Rv	AGCCGCGGTAATACGGAAGGTC	GCCGGCCTACGCTCCCTTTAAA
Pig21Fw:Pig120Rv	AGCCGCGGTAATACGGAAGGTC	GGCATTTCACAACACGCTTAAA
Pig21Fw:Pig121Rv	AGCCGCGGTAATACGGAAGGTC	TTATTCATGCGGTACCTGCAAA
Pig22Fw:Pig1Rv	AGCGGTGAAATGCTTAGATATC	CCTGCACGCTACTTGGCTGGTT
Pig22Fw:Pig2Rv	AGCGGTGAAATGCTTAGATATC	AGCTGCCTTCGCAATCGGAGTT
Pig22Fw:Pig3Rv	AGCGGTGAAATGCTTAGATATC	TGCCTTCGCAATCGGAGTTCTT
Pig22Fw:Pig4Rv	AGCGGTGAAATGCTTAGATATC	CGCGGCATTTCACAACACGCTT
Pig22Fw:Pig5Rv	AGCGGTGAAATGCTTAGATATC	CGATACCCGCACTTTCGAGCTT
Pig22Fw:Pig6Rv	AGCGGTGAAATGCTTAGATATC	GGCACGGAATTAGCCGGTCCTT
Pig22Fw:Pig7Rv	AGCGGTGAAATGCTTAGATATC	TAACGCTACGGTAAGCTGCCTT
Pig22Fw:Pig8Rv	AGCGGTGAAATGCTTAGATATC	GCCGTCATCCTGCACGCTACTT
Pig22Fw:Pig9Rv	AGCGGTGAAATGCTTAGATATC	ACGGAATTAGCCGGTCCTTATT
Pig22Fw:Pig10Rv	AGCGGTGAAATGCTTAGATATC	CTGGTTCAGACTTACGTCCATT
Pig22Fw:Pig11Rv	AGCGGTGAAATGCTTAGATATC	TCCTGCACGCTACTTGGCTGGT
Pig22Fw:Pig12Rv	AGCGGTGAAATGCTTAGATATC	TGCTGGCACGGAATTAGCCGGT
Pig22Fw:Pig13Rv	AGCGGTGAAATGCTTAGATATC	CCGCACTTTCGAGCTTCAGCGT
Pig22Fw:Pig14Rv	AGCGGTGAAATGCTTAGATATC	AGTTTACAACCCATAGGGCCGT
Pig22Fw:Pig15Rv	AGCGGTGAAATGCTTAGATATC	CTTGGCTGGTTCAGACTTACGT
Pig22Fw:Pig16Rv	AGCGGTGAAATGCTTAGATATC	AAGCTGCCTTCGCAATCGGAGT
Pig22Fw:Pig17Rv	AGCGGTGAAATGCTTAGATATC	CTGCCTTCGCAATCGGAGTTCT
Pig22Fw:Pig18Rv	AGCGGTGAAATGCTTAGATATC	ATCGGAGTTCTTCGTGATATCT
Pig22Fw:Pig19Rv	AGCGGTGAAATGCTTAGATATC	CTTCCGTATTACCGCGGCTGCT
Pig22Fw:Pig20Rv	AGCGGTGAAATGCTTAGATATC	TCATCCTGCACGCTACTTGGCT
Pig22Fw:Pig21Rv	AGCGGTGAAATGCTTAGATATC	GACCTTCCGTATTACCGCGGCT
Pig22Fw:Pig22Rv	AGCGGTGAAATGCTTAGATATC	GATATCTAAGCATTTCACCGCT
Pig22Fw:Pig23Rv	AGCGGTGAAATGCTTAGATATC	CCGCGGCATTTCACAACACGCT
Pig22Fw:Pig24Rv	AGCGGTGAAATGCTTAGATATC	TGGCACGGAATTAGCCGGTCCT
Pig22Fw:Pig25Rv	AGCGGTGAAATGCTTAGATATC	CAACCCATAGGGCCGTCATCCT
Pig22Fw:Pig26Rv	AGCGGTGAAATGCTTAGATATC	CGCTACACCACGAATTCCGCCT
Pig22Fw:Pig27Rv	AGCGGTGAAATGCTTAGATATC	GGTCCTTATTCATGCGGTACCT
Pig22Fw:Pig28Rv	AGCGGTGAAATGCTTAGATATC	ACACCACGAATTCCGCCTACCT
Pig22Fw:Pig29Rv	AGCGGTGAAATGCTTAGATATC	CGCTACTTGGCTGGTTCAGACT
Pig22Fw:Pig30Rv	AGCGGTGAAATGCTTAGATATC	CACGGAATTAGCCGGTCCTTAT
Pig22Fw:Pig31Rv	AGCGGTGAAATGCTTAGATATC	CAATCGGAGTTCTTCGTGATAT
Pig22Fw:Pig32Rv	AGCGGTGAAATGCTTAGATATC	CGCAATCGGAGTTCTTCGTGAT
Pig22Fw:Pig33Rv	AGCGGTGAAATGCTTAGATATC	TTACAACCCATAGGGCCGTCAT
Pig22Fw:Pig34Rv	AGCGGTGAAATGCTTAGATATC	GCTGGTTCAGACTTACGTCCAT
Pig22Fw:Pig35Rv	AGCGGTGAAATGCTTAGATATC	TACGGTAAGCTGCCTTCGCAAT
Pig22Fw:Pig36Rv	AGCGGTGAAATGCTTAGATATC	CTACGCTCCCTTTAAACCCAAT
Pig22Fw:Pig37Rv	AGCGGTGAAATGCTTAGATATC	CCGTCATCCTGCACGCTACTTG
Pig22Fw:Pig38Rv	AGCGGTGAAATGCTTAGATATC	TGGTTCAGACTTACGTCCATTG
Pig22Fw:Pig39Rv	AGCGGTGAAATGCTTAGATATC	TTCCGTATTACCGCGGCTGCTG
Pig22Fw:Pig40Rv	AGCGGTGAAATGCTTAGATATC	CATCCTGCACGCTACTTGGCTG
Pig22Fw:Pig41Rv	AGCGGTGAAATGCTTAGATATC	ACCTTCCGTATTACCGCGGCTG
Pig22Fw:Pig42Rv	AGCGGTGAAATGCTTAGATATC	AACCCATAGGGCCGTCATCCTG
Pig22Fw:Pig43Rv	AGCGGTGAAATGCTTAGATATC	GTCCTTATTCATGCGGTACCTG
Pig22Fw:Pig44Rv	AGCGGTGAAATGCTTAGATATC	AATTAGCCGGTCCTTATTCATG
Pig22Fw:Pig45Rv	AGCGGTGAAATGCTTAGATATC	CGTCATCCTGCACGCTACTTGG
Pig22Fw:Pig46Rv	AGCGGTGAAATGCTTAGATATC	ATCCTGCACGCTACTTGGCTGG
Pig22Fw:Pig47Rv	AGCGGTGAAATGCTTAGATATC	AAGCAGTTTACAACCCATAGGG
Pig22Fw:Pig48Rv	AGCGGTGAAATGCTTAGATATC	GGTAAGCTGCCTTCGCAATCGG
Pig22Fw:Pig49Rv	AGCGGTGAAATGCTTAGATATC	TAGCCGGTCCTTATTCATGCGG
Pig22Fw:Pig50Rv	AGCGGTGAAATGCTTAGATATC	AAAGCAGTTTACAACCCATAGG
Pig22Fw:Pig51Rv	AGCGGTGAAATGCTTAGATATC	ACGCTACGGTAAGCTGCCTTCG
Pig22Fw:Pig52Rv	AGCGGTGAAATGCTTAGATATC	CGGTAAGCTGCCTTCGCAATCG
Pig22Fw:Pig53Rv	AGCGGTGAAATGCTTAGATATC	TTAGCCGGTCCTTATTCATGCG
Pig22Fw:Pig54Rv	AGCGGTGAAATGCTTAGATATC	CAGTTTACAACCCATAGGGCCG
Pig22Fw:Pig55Rv	AGCGGTGAAATGCTTAGATATC	TAAGCTGCCTTCGCAATCGGAG
Pig22Fw:Pig56Rv	AGCGGTGAAATGCTTAGATATC	GCACGCTACTTGGCTGGTTCAG
Pig22Fw:Pig57Rv	AGCGGTGAAATGCTTAGATATC	TACCCGCACTTTCGAGCTTCAG
Pig22Fw:Pig58Rv	AGCGGTGAAATGCTTAGATATC	GGAGTTCTTCGTGATATCTAAG
Pig22Fw:Pig59Rv	AGCGGTGAAATGCTTAGATATC	CTGCACGCTACTTGGCTGGTTC
Pig22Fw:Pig60Rv	AGCGGTGAAATGCTTAGATATC	GCTGCCTTCGCAATCGGAGTTC
Pig22Fw:Pig61Rv	AGCGGTGAAATGCTTAGATATC	GATACCCGCACTTTCGAGCTTC
Pig22Fw:Pig62Rv	AGCGGTGAAATGCTTAGATATC	AACGCTACGGTAAGCTGCCTTC
Pig22Fw:Pig63Rv	AGCGGTGAAATGCTTAGATATC	CGCACTTTCGAGCTTCAGCGTC
Pig22Fw:Pig64Rv	AGCGGTGAAATGCTTAGATATC	GTTTACAACCCATAGGGCCGTC
Pig22Fw:Pig65Rv	AGCGGTGAAATGCTTAGATATC	TTGGCTGGTTCAGACTTACGTC
Pig22Fw:Pig66Rv	AGCGGTGAAATGCTTAGATATC	CACCACGAATTCCGCCTACCTC
Pig22Fw:Pig67Rv	AGCGGTGAAATGCTTAGATATC	AATCGGAGTTCTTCGTGATATC
Pig22Fw:Pig68Rv	AGCGGTGAAATGCTTAGATATC	TACAACCCATAGGGCCGTCATC
Pig22Fw:Pig69Rv	AGCGGTGAAATGCTTAGATATC	ACGGTAAGCTGCCTTCGCAATC
Pig22Fw:Pig70Rv	AGCGGTGAAATGCTTAGATATC	TCCTTATTCATGCGGTACCTGC
Pig22Fw:Pig71Rv	AGCGGTGAAATGCTTAGATATC	ATTAGCCGGTCCTTATTCATGC
Pig22Fw:Pig72Rv	AGCGGTGAAATGCTTAGATATC	GTCATCCTGCACGCTACTTGGC
Pig22Fw:Pig73Rv	AGCGGTGAAATGCTTAGATATC	AGCAGTTTACAACCCATAGGGC
Pig22Fw:Pig74Rv	AGCGGTGAAATGCTTAGATATC	TGATATCTAAGCATTTCACCGC
Pig22Fw:Pig75Rv	AGCGGTGAAATGCTTAGATATC	ACCCGCACTTTCGAGCTTCAGC
Pig22Fw:Pig76Rv	AGCGGTGAAATGCTTAGATATC	GAGTTCTTCGTGATATCTAAGC
Pig22Fw:Pig77Rv	AGCGGTGAAATGCTTAGATATC	TGGCTGGTTCAGACTTACGTCC
Pig22Fw:Pig78Rv	AGCGGTGAAATGCTTAGATATC	ACCACGAATTCCGCCTACCTCC
Pig22Fw:Pig79Rv	AGCGGTGAAATGCTTAGATATC	ACAACCCATAGGGCCGTCATCC
Pig22Fw:Pig80Rv	AGCGGTGAAATGCTTAGATATC	GCAGTTTACAACCCATAGGGCC
Pig22Fw:Pig81Rv	AGCGGTGAAATGCTTAGATATC	GGCCTACGCTCCCTTTAAACCC
Pig22Fw:Pig82Rv	AGCGGTGAAATGCTTAGATATC	TACACCACGAATTCCGCCTACC
Pig22Fw:Pig83Rv	AGCGGTGAAATGCTTAGATATC	TTCAGACTTACGTCCATTGACC
Pig22Fw:Pig84Rv	AGCGGTGAAATGCTTAGATATC	CGGCCTACGCTCCCTTTAAACC
Pig22Fw:Pig85Rv	AGCGGTGAAATGCTTAGATATC	TATCTAAGCATTTCACCGCTAC
Pig22Fw:Pig86Rv	AGCGGTGAAATGCTTAGATATC	GTTCAGACTTACGTCCATTGAC
Pig22Fw:Pig87Rv	AGCGGTGAAATGCTTAGATATC	ACGCTACTTGGCTGGTTCAGAC
Pig22Fw:Pig88Rv	AGCGGTGAAATGCTTAGATATC	TCTAAGCATTTCACCGCTACAC
Pig22Fw:Pig89Rv	AGCGGTGAAATGCTTAGATATC	CCGGCCTACGCTCCCTTTAAAC
Pig22Fw:Pig90Rv	AGCGGTGAAATGCTTAGATATC	AAGCCGGCCTACGCTCCCTTTA
Pig22Fw:Pig91Rv	AGCGGTGAAATGCTTAGATATC	GCGGCATTTCACAACACGCTTA
Pig22Fw:Pig92Rv	AGCGGTGAAATGCTTAGATATC	GCACGGAATTAGCCGGTCCTTA
Pig22Fw:Pig93Rv	AGCGGTGAAATGCTTAGATATC	TCGGAGTTCTTCGTGATATCTA
Pig22Fw:Pig94Rv	AGCGGTGAAATGCTTAGATATC	GCTACACCACGAATTCCGCCTA
Pig22Fw:Pig95Rv	AGCGGTGAAATGCTTAGATATC	GCAATCGGAGTTCTTCGTGATA
Pig22Fw:Pig96Rv	AGCGGTGAAATGCTTAGATATC	TACGCTCCCTTTAAACCCAATA
Pig22Fw:Pig97Rv	AGCGGTGAAATGCTTAGATATC	GGTTCAGACTTACGTCCATTGA
Pig22Fw:Pig98Rv	AGCGGTGAAATGCTTAGATATC	TCGCAATCGGAGTTCTTCGTGA
Pig22Fw:Pig99Rv	AGCGGTGAAATGCTTAGATATC	GTAAGCTGCCTTCGCAATCGGA
Pig22Fw:Pig100Rv	AGCGGTGAAATGCTTAGATATC	CACGCTACTTGGCTGGTTCAGA
Pig22Fw:Pig101Rv	AGCGGTGAAATGCTTAGATATC	TGCACGCTACTTGGCTGGTTCA
Pig22Fw:Pig102Rv	AGCGGTGAAATGCTTAGATATC	ATACCCGCACTTTCGAGCTTCA
Pig22Fw:Pig103Rv	AGCGGTGAAATGCTTAGATATC	GCACTTTCGAGCTTCAGCGTCA
Pig22Fw:Pig104Rv	AGCGGTGAAATGCTTAGATATC	TTTACAACCCATAGGGCCGTCA
Pig22Fw:Pig105Rv	AGCGGTGAAATGCTTAGATATC	CCTTATTCATGCGGTACCTGCA
Pig22Fw:Pig106Rv	AGCGGTGAAATGCTTAGATATC	GCTACGGTAAGCTGCCTTCGCA
Pig22Fw:Pig107Rv	AGCGGTGAAATGCTTAGATATC	GGCTGGTTCAGACTTACGTCCA
Pig22Fw:Pig108Rv	AGCGGTGAAATGCTTAGATATC	GCCTACGCTCCCTTTAAACCCA
Pig22Fw:Pig109Rv	AGCGGTGAAATGCTTAGATATC	TCAGACTTACGTCCATTGACCA
Pig22Fw:Pig110Rv	AGCGGTGAAATGCTTAGATATC	ATCTAAGCATTTCACCGCTACA
Pig22Fw:Pig111Rv	AGCGGTGAAATGCTTAGATATC	AGCCGGCCTACGCTCCCTTTAA
Pig22Fw:Pig112Rv	AGCGGTGAAATGCTTAGATATC	CGGCATTTCACAACACGCTTAA
Pig22Fw:Pig113Rv	AGCGGTGAAATGCTTAGATATC	CGGAGTTCTTCGTGATATCTAA
Pig22Fw:Pig114Rv	AGCGGTGAAATGCTTAGATATC	ACGCTCCCTTTAAACCCAATAA
Pig22Fw:Pig115Rv	AGCGGTGAAATGCTTAGATATC	CTTATTCATGCGGTACCTGCAA
Pig22Fw:Pig116Rv	AGCGGTGAAATGCTTAGATATC	CTACGGTAAGCTGCCTTCGCAA
Pig22Fw:Pig117Rv	AGCGGTGAAATGCTTAGATATC	CCTACGCTCCCTTTAAACCCAA
Pig22Fw:Pig118Rv	AGCGGTGAAATGCTTAGATATC	CAGACTTACGTCCATTGACCAA
Pig22Fw:Pig119Rv	AGCGGTGAAATGCTTAGATATC	GCCGGCCTACGCTCCCTTTAAA
Pig22Fw:Pig120Rv	AGCGGTGAAATGCTTAGATATC	GGCATTTCACAACACGCTTAAA
Pig22Fw:Pig121Rv	AGCGGTGAAATGCTTAGATATC	TTATTCATGCGGTACCTGCAAA
Pig23Fw:Pig1Rv	AGCGTGTTGTGAAATGCCGCGG	CCTGCACGCTACTTGGCTGGTT
Pig23Fw:Pig2Rv	AGCGTGTTGTGAAATGCCGCGG	AGCTGCCTTCGCAATCGGAGTT
Pig23Fw:Pig3Rv	AGCGTGTTGTGAAATGCCGCGG	TGCCTTCGCAATCGGAGTTCTT
Pig23Fw:Pig4Rv	AGCGTGTTGTGAAATGCCGCGG	CGCGGCATTTCACAACACGCTT
Pig23Fw:Pig5Rv	AGCGTGTTGTGAAATGCCGCGG	CGATACCCGCACTTTCGAGCTT
Pig23Fw:Pig6Rv	AGCGTGTTGTGAAATGCCGCGG	GGCACGGAATTAGCCGGTCCTT
Pig23Fw:Pig7Rv	AGCGTGTTGTGAAATGCCGCGG	TAACGCTACGGTAAGCTGCCTT
Pig23Fw:Pig8Rv	AGCGTGTTGTGAAATGCCGCGG	GCCGTCATCCTGCACGCTACTT
Pig23Fw:Pig9Rv	AGCGTGTTGTGAAATGCCGCGG	ACGGAATTAGCCGGTCCTTATT
Pig23Fw:Pig10Rv	AGCGTGTTGTGAAATGCCGCGG	CTGGTTCAGACTTACGTCCATT
Pig23Fw:Pig11Rv	AGCGTGTTGTGAAATGCCGCGG	TCCTGCACGCTACTTGGCTGGT
Pig23Fw:Pig12Rv	AGCGTGTTGTGAAATGCCGCGG	TGCTGGCACGGAATTAGCCGGT
Pig23Fw:Pig13Rv	AGCGTGTTGTGAAATGCCGCGG	CCGCACTTTCGAGCTTCAGCGT
Pig23Fw:Pig14Rv	AGCGTGTTGTGAAATGCCGCGG	AGTTTACAACCCATAGGGCCGT
Pig23Fw:Pig15Rv	AGCGTGTTGTGAAATGCCGCGG	CTTGGCTGGTTCAGACTTACGT
Pig23Fw:Pig16Rv	AGCGTGTTGTGAAATGCCGCGG	AAGCTGCCTTCGCAATCGGAGT
Pig23Fw:Pig17Rv	AGCGTGTTGTGAAATGCCGCGG	CTGCCTTCGCAATCGGAGTTCT
Pig23Fw:Pig18Rv	AGCGTGTTGTGAAATGCCGCGG	ATCGGAGTTCTTCGTGATATCT
Pig23Fw:Pig19Rv	AGCGTGTTGTGAAATGCCGCGG	CTTCCGTATTACCGCGGCTGCT
Pig23Fw:Pig20Rv	AGCGTGTTGTGAAATGCCGCGG	TCATCCTGCACGCTACTTGGCT
Pig23Fw:Pig21Rv	AGCGTGTTGTGAAATGCCGCGG	GACCTTCCGTATTACCGCGGCT
Pig23Fw:Pig22Rv	AGCGTGTTGTGAAATGCCGCGG	GATATCTAAGCATTTCACCGCT
Pig23Fw:Pig23Rv	AGCGTGTTGTGAAATGCCGCGG	CCGCGGCATTTCACAACACGCT
Pig23Fw:Pig24Rv	AGCGTGTTGTGAAATGCCGCGG	TGGCACGGAATTAGCCGGTCCT
Pig23Fw:Pig25Rv	AGCGTGTTGTGAAATGCCGCGG	CAACCCATAGGGCCGTCATCCT
Pig23Fw:Pig26Rv	AGCGTGTTGTGAAATGCCGCGG	CGCTACACCACGAATTCCGCCT
Pig23Fw:Pig27Rv	AGCGTGTTGTGAAATGCCGCGG	GGTCCTTATTCATGCGGTACCT
Pig23Fw:Pig28Rv	AGCGTGTTGTGAAATGCCGCGG	ACACCACGAATTCCGCCTACCT
Pig23Fw:Pig29Rv	AGCGTGTTGTGAAATGCCGCGG	CGCTACTTGGCTGGTTCAGACT
Pig23Fw:Pig30Rv	AGCGTGTTGTGAAATGCCGCGG	CACGGAATTAGCCGGTCCTTAT
Pig23Fw:Pig31Rv	AGCGTGTTGTGAAATGCCGCGG	CAATCGGAGTTCTTCGTGATAT
Pig23Fw:Pig32Rv	AGCGTGTTGTGAAATGCCGCGG	CGCAATCGGAGTTCTTCGTGAT
Pig23Fw:Pig33Rv	AGCGTGTTGTGAAATGCCGCGG	TTACAACCCATAGGGCCGTCAT
Pig23Fw:Pig34Rv	AGCGTGTTGTGAAATGCCGCGG	GCTGGTTCAGACTTACGTCCAT
Pig23Fw:Pig35Rv	AGCGTGTTGTGAAATGCCGCGG	TACGGTAAGCTGCCTTCGCAAT
Pig23Fw:Pig36Rv	AGCGTGTTGTGAAATGCCGCGG	CTACGCTCCCTTTAAACCCAAT
Pig23Fw:Pig37Rv	AGCGTGTTGTGAAATGCCGCGG	CCGTCATCCTGCACGCTACTTG
Pig23Fw:Pig38Rv	AGCGTGTTGTGAAATGCCGCGG	TGGTTCAGACTTACGTCCATTG
Pig23Fw:Pig39Rv	AGCGTGTTGTGAAATGCCGCGG	TTCCGTATTACCGCGGCTGCTG
Pig23Fw:Pig40Rv	AGCGTGTTGTGAAATGCCGCGG	CATCCTGCACGCTACTTGGCTG
Pig23Fw:Pig41Rv	AGCGTGTTGTGAAATGCCGCGG	ACCTTCCGTATTACCGCGGCTG
Pig23Fw:Pig42Rv	AGCGTGTTGTGAAATGCCGCGG	AACCCATAGGGCCGTCATCCTG
Pig23Fw:Pig43Rv	AGCGTGTTGTGAAATGCCGCGG	GTCCTTATTCATGCGGTACCTG
Pig23Fw:Pig44Rv	AGCGTGTTGTGAAATGCCGCGG	AATTAGCCGGTCCTTATTCATG
Pig23Fw:Pig45Rv	AGCGTGTTGTGAAATGCCGCGG	CGTCATCCTGCACGCTACTTGG
Pig23Fw:Pig46Rv	AGCGTGTTGTGAAATGCCGCGG	ATCCTGCACGCTACTTGGCTGG
Pig23Fw:Pig47Rv	AGCGTGTTGTGAAATGCCGCGG	AAGCAGTTTACAACCCATAGGG
Pig23Fw:Pig48Rv	AGCGTGTTGTGAAATGCCGCGG	GGTAAGCTGCCTTCGCAATCGG
Pig23Fw:Pig49Rv	AGCGTGTTGTGAAATGCCGCGG	TAGCCGGTCCTTATTCATGCGG
Pig23Fw:Pig50Rv	AGCGTGTTGTGAAATGCCGCGG	AAAGCAGTTTACAACCCATAGG
Pig23Fw:Pig51Rv	AGCGTGTTGTGAAATGCCGCGG	ACGCTACGGTAAGCTGCCTTCG
Pig23Fw:Pig52Rv	AGCGTGTTGTGAAATGCCGCGG	CGGTAAGCTGCCTTCGCAATCG
Pig23Fw:Pig53Rv	AGCGTGTTGTGAAATGCCGCGG	TTAGCCGGTCCTTATTCATGCG
Pig23Fw:Pig54Rv	AGCGTGTTGTGAAATGCCGCGG	CAGTTTACAACCCATAGGGCCG
Pig23Fw:Pig55Rv	AGCGTGTTGTGAAATGCCGCGG	TAAGCTGCCTTCGCAATCGGAG
Pig23Fw:Pig56Rv	AGCGTGTTGTGAAATGCCGCGG	GCACGCTACTTGGCTGGTTCAG
Pig23Fw:Pig57Rv	AGCGTGTTGTGAAATGCCGCGG	TACCCGCACTTTCGAGCTTCAG
Pig23Fw:Pig58Rv	AGCGTGTTGTGAAATGCCGCGG	GGAGTTCTTCGTGATATCTAAG
Pig23Fw:Pig59Rv	AGCGTGTTGTGAAATGCCGCGG	CTGCACGCTACTTGGCTGGTTC
Pig23Fw:Pig60Rv	AGCGTGTTGTGAAATGCCGCGG	GCTGCCTTCGCAATCGGAGTTC
Pig23Fw:Pig61Rv	AGCGTGTTGTGAAATGCCGCGG	GATACCCGCACTTTCGAGCTTC
Pig23Fw:Pig62Rv	AGCGTGTTGTGAAATGCCGCGG	AACGCTACGGTAAGCTGCCTTC
Pig23Fw:Pig63Rv	AGCGTGTTGTGAAATGCCGCGG	CGCACTTTCGAGCTTCAGCGTC
Pig23Fw:Pig64Rv	AGCGTGTTGTGAAATGCCGCGG	GTTTACAACCCATAGGGCCGTC
Pig23Fw:Pig65Rv	AGCGTGTTGTGAAATGCCGCGG	TTGGCTGGTTCAGACTTACGTC
Pig23Fw:Pig66Rv	AGCGTGTTGTGAAATGCCGCGG	CACCACGAATTCCGCCTACCTC
Pig23Fw:Pig67Rv	AGCGTGTTGTGAAATGCCGCGG	AATCGGAGTTCTTCGTGATATC
Pig23Fw:Pig68Rv	AGCGTGTTGTGAAATGCCGCGG	TACAACCCATAGGGCCGTCATC
Pig23Fw:Pig69Rv	AGCGTGTTGTGAAATGCCGCGG	ACGGTAAGCTGCCTTCGCAATC
Pig23Fw:Pig70Rv	AGCGTGTTGTGAAATGCCGCGG	TCCTTATTCATGCGGTACCTGC
Pig23Fw:Pig71Rv	AGCGTGTTGTGAAATGCCGCGG	ATTAGCCGGTCCTTATTCATGC
Pig23Fw:Pig72Rv	AGCGTGTTGTGAAATGCCGCGG	GTCATCCTGCACGCTACTTGGC
Pig23Fw:Pig73Rv	AGCGTGTTGTGAAATGCCGCGG	AGCAGTTTACAACCCATAGGGC
Pig23Fw:Pig74Rv	AGCGTGTTGTGAAATGCCGCGG	TGATATCTAAGCATTTCACCGC
Pig23Fw:Pig75Rv	AGCGTGTTGTGAAATGCCGCGG	ACCCGCACTTTCGAGCTTCAGC
Pig23Fw:Pig76Rv	AGCGTGTTGTGAAATGCCGCGG	GAGTTCTTCGTGATATCTAAGC
Pig23Fw:Pig77Rv	AGCGTGTTGTGAAATGCCGCGG	TGGCTGGTTCAGACTTACGTCC
Pig23Fw:Pig78Rv	AGCGTGTTGTGAAATGCCGCGG	ACCACGAATTCCGCCTACCTCC
Pig23Fw:Pig79Rv	AGCGTGTTGTGAAATGCCGCGG	ACAACCCATAGGGCCGTCATCC
Pig23Fw:Pig80Rv	AGCGTGTTGTGAAATGCCGCGG	GCAGTTTACAACCCATAGGGCC
Pig23Fw:Pig81Rv	AGCGTGTTGTGAAATGCCGCGG	GGCCTACGCTCCCTTTAAACCC
Pig23Fw:Pig82Rv	AGCGTGTTGTGAAATGCCGCGG	TACACCACGAATTCCGCCTACC
Pig23Fw:Pig83Rv	AGCGTGTTGTGAAATGCCGCGG	TTCAGACTTACGTCCATTGACC
Pig23Fw:Pig84Rv	AGCGTGTTGTGAAATGCCGCGG	CGGCCTACGCTCCCTTTAAACC
Pig23Fw:Pig85Rv	AGCGTGTTGTGAAATGCCGCGG	TATCTAAGCATTTCACCGCTAC
Pig23Fw:Pig86Rv	AGCGTGTTGTGAAATGCCGCGG	GTTCAGACTTACGTCCATTGAC
Pig23Fw:Pig87Rv	AGCGTGTTGTGAAATGCCGCGG	ACGCTACTTGGCTGGTTCAGAC
Pig23Fw:Pig88Rv	AGCGTGTTGTGAAATGCCGCGG	TCTAAGCATTTCACCGCTACAC
Pig23Fw:Pig89Rv	AGCGTGTTGTGAAATGCCGCGG	CCGGCCTACGCTCCCTTTAAAC
Pig23Fw:Pig90Rv	AGCGTGTTGTGAAATGCCGCGG	AAGCCGGCCTACGCTCCCTTTA
Pig23Fw:Pig91Rv	AGCGTGTTGTGAAATGCCGCGG	GCGGCATTTCACAACACGCTTA
Pig23Fw:Pig92Rv	AGCGTGTTGTGAAATGCCGCGG	GCACGGAATTAGCCGGTCCTTA
Pig23Fw:Pig93Rv	AGCGTGTTGTGAAATGCCGCGG	TCGGAGTTCTTCGTGATATCTA
Pig23Fw:Pig94Rv	AGCGTGTTGTGAAATGCCGCGG	GCTACACCACGAATTCCGCCTA
Pig23Fw:Pig95Rv	AGCGTGTTGTGAAATGCCGCGG	GCAATCGGAGTTCTTCGTGATA
Pig23Fw:Pig96Rv	AGCGTGTTGTGAAATGCCGCGG	TACGCTCCCTTTAAACCCAATA
Pig23Fw:Pig97Rv	AGCGTGTTGTGAAATGCCGCGG	GGTTCAGACTTACGTCCATTGA
Pig23Fw:Pig98Rv	AGCGTGTTGTGAAATGCCGCGG	TCGCAATCGGAGTTCTTCGTGA
Pig23Fw:Pig99Rv	AGCGTGTTGTGAAATGCCGCGG	GTAAGCTGCCTTCGCAATCGGA
Pig23Fw:Pig100Rv	AGCGTGTTGTGAAATGCCGCGG	CACGCTACTTGGCTGGTTCAGA
Pig23Fw:Pig101Rv	AGCGTGTTGTGAAATGCCGCGG	TGCACGCTACTTGGCTGGTTCA
Pig23Fw:Pig102Rv	AGCGTGTTGTGAAATGCCGCGG	ATACCCGCACTTTCGAGCTTCA
Pig23Fw:Pig103Rv	AGCGTGTTGTGAAATGCCGCGG	GCACTTTCGAGCTTCAGCGTCA
Pig23Fw:Pig104Rv	AGCGTGTTGTGAAATGCCGCGG	TTTACAACCCATAGGGCCGTCA
Pig23Fw:Pig105Rv	AGCGTGTTGTGAAATGCCGCGG	CCTTATTCATGCGGTACCTGCA
Pig23Fw:Pig106Rv	AGCGTGTTGTGAAATGCCGCGG	GCTACGGTAAGCTGCCTTCGCA
Pig23Fw:Pig107Rv	AGCGTGTTGTGAAATGCCGCGG	GGCTGGTTCAGACTTACGTCCA
Pig23Fw:Pig108Rv	AGCGTGTTGTGAAATGCCGCGG	GCCTACGCTCCCTTTAAACCCA
Pig23Fw:Pig109Rv	AGCGTGTTGTGAAATGCCGCGG	TCAGACTTACGTCCATTGACCA
Pig23Fw:Pig110Rv	AGCGTGTTGTGAAATGCCGCGG	ATCTAAGCATTTCACCGCTACA
Pig23Fw:Pig111Rv	AGCGTGTTGTGAAATGCCGCGG	AGCCGGCCTACGCTCCCTTTAA
Pig23Fw:Pig112Rv	AGCGTGTTGTGAAATGCCGCGG	CGGCATTTCACAACACGCTTAA
Pig23Fw:Pig113Rv	AGCGTGTTGTGAAATGCCGCGG	CGGAGTTCTTCGTGATATCTAA
Pig23Fw:Pig114Rv	AGCGTGTTGTGAAATGCCGCGG	ACGCTCCCTTTAAACCCAATAA
Pig23Fw:Pig115Rv	AGCGTGTTGTGAAATGCCGCGG	CTTATTCATGCGGTACCTGCAA
Pig23Fw:Pig116Rv	AGCGTGTTGTGAAATGCCGCGG	CTACGGTAAGCTGCCTTCGCAA
Pig23Fw:Pig117Rv	AGCGTGTTGTGAAATGCCGCGG	CCTACGCTCCCTTTAAACCCAA
Pig23Fw:Pig118Rv	AGCGTGTTGTGAAATGCCGCGG	CAGACTTACGTCCATTGACCAA
Pig23Fw:Pig119Rv	AGCGTGTTGTGAAATGCCGCGG	GCCGGCCTACGCTCCCTTTAAA
Pig23Fw:Pig120Rv	AGCGTGTTGTGAAATGCCGCGG	GGCATTTCACAACACGCTTAAA
Pig23Fw:Pig121Rv	AGCGTGTTGTGAAATGCCGCGG	TTATTCATGCGGTACCTGCAAA
Pig24Fw:Pig1Rv	AGGACCGGCTAATTCCGTGCCA	CCTGCACGCTACTTGGCTGGTT
Pig24Fw:Pig2Rv	AGGACCGGCTAATTCCGTGCCA	AGCTGCCTTCGCAATCGGAGTT
Pig24Fw:Pig3Rv	AGGACCGGCTAATTCCGTGCCA	TGCCTTCGCAATCGGAGTTCTT
Pig24Fw:Pig4Rv	AGGACCGGCTAATTCCGTGCCA	CGCGGCATTTCACAACACGCTT
Pig24Fw:Pig5Rv	AGGACCGGCTAATTCCGTGCCA	CGATACCCGCACTTTCGAGCTT
Pig24Fw:Pig6Rv	AGGACCGGCTAATTCCGTGCCA	GGCACGGAATTAGCCGGTCCTT
Pig24Fw:Pig7Rv	AGGACCGGCTAATTCCGTGCCA	TAACGCTACGGTAAGCTGCCTT
Pig24Fw:Pig8Rv	AGGACCGGCTAATTCCGTGCCA	GCCGTCATCCTGCACGCTACTT
Pig24Fw:Pig9Rv	AGGACCGGCTAATTCCGTGCCA	ACGGAATTAGCCGGTCCTTATT
Pig24Fw:Pig10Rv	AGGACCGGCTAATTCCGTGCCA	CTGGTTCAGACTTACGTCCATT
Pig24Fw:Pig11Rv	AGGACCGGCTAATTCCGTGCCA	TCCTGCACGCTACTTGGCTGGT
Pig24Fw:Pig12Rv	AGGACCGGCTAATTCCGTGCCA	TGCTGGCACGGAATTAGCCGGT
Pig24Fw:Pig13Rv	AGGACCGGCTAATTCCGTGCCA	CCGCACTTTCGAGCTTCAGCGT
Pig24Fw:Pig14Rv	AGGACCGGCTAATTCCGTGCCA	AGTTTACAACCCATAGGGCCGT
Pig24Fw:Pig15Rv	AGGACCGGCTAATTCCGTGCCA	CTTGGCTGGTTCAGACTTACGT
Pig24Fw:Pig16Rv	AGGACCGGCTAATTCCGTGCCA	AAGCTGCCTTCGCAATCGGAGT
Pig24Fw:Pig17Rv	AGGACCGGCTAATTCCGTGCCA	CTGCCTTCGCAATCGGAGTTCT
Pig24Fw:Pig18Rv	AGGACCGGCTAATTCCGTGCCA	ATCGGAGTTCTTCGTGATATCT
Pig24Fw:Pig19Rv	AGGACCGGCTAATTCCGTGCCA	CTTCCGTATTACCGCGGCTGCT
Pig24Fw:Pig20Rv	AGGACCGGCTAATTCCGTGCCA	TCATCCTGCACGCTACTTGGCT
Pig24Fw:Pig21Rv	AGGACCGGCTAATTCCGTGCCA	GACCTTCCGTATTACCGCGGCT
Pig24Fw:Pig22Rv	AGGACCGGCTAATTCCGTGCCA	GATATCTAAGCATTTCACCGCT
Pig24Fw:Pig23Rv	AGGACCGGCTAATTCCGTGCCA	CCGCGGCATTTCACAACACGCT
Pig24Fw:Pig24Rv	AGGACCGGCTAATTCCGTGCCA	TGGCACGGAATTAGCCGGTCCT
Pig24Fw:Pig25Rv	AGGACCGGCTAATTCCGTGCCA	CAACCCATAGGGCCGTCATCCT
Pig24Fw:Pig26Rv	AGGACCGGCTAATTCCGTGCCA	CGCTACACCACGAATTCCGCCT
Pig24Fw:Pig27Rv	AGGACCGGCTAATTCCGTGCCA	GGTCCTTATTCATGCGGTACCT
Pig24Fw:Pig28Rv	AGGACCGGCTAATTCCGTGCCA	ACACCACGAATTCCGCCTACCT
Pig24Fw:Pig29Rv	AGGACCGGCTAATTCCGTGCCA	CGCTACTTGGCTGGTTCAGACT
Pig24Fw:Pig30Rv	AGGACCGGCTAATTCCGTGCCA	CACGGAATTAGCCGGTCCTTAT
Pig24Fw:Pig31Rv	AGGACCGGCTAATTCCGTGCCA	CAATCGGAGTTCTTCGTGATAT
Pig24Fw:Pig32Rv	AGGACCGGCTAATTCCGTGCCA	CGCAATCGGAGTTCTTCGTGAT
Pig24Fw:Pig33Rv	AGGACCGGCTAATTCCGTGCCA	TTACAACCCATAGGGCCGTCAT
Pig24Fw:Pig34Rv	AGGACCGGCTAATTCCGTGCCA	GCTGGTTCAGACTTACGTCCAT
Pig24Fw:Pig35Rv	AGGACCGGCTAATTCCGTGCCA	TACGGTAAGCTGCCTTCGCAAT
Pig24Fw:Pig36Rv	AGGACCGGCTAATTCCGTGCCA	CTACGCTCCCTTTAAACCCAAT
Pig24Fw:Pig37Rv	AGGACCGGCTAATTCCGTGCCA	CCGTCATCCTGCACGCTACTTG
Pig24Fw:Pig38Rv	AGGACCGGCTAATTCCGTGCCA	TGGTTCAGACTTACGTCCATTG
Pig24Fw:Pig39Rv	AGGACCGGCTAATTCCGTGCCA	TTCCGTATTACCGCGGCTGCTG
Pig24Fw:Pig40Rv	AGGACCGGCTAATTCCGTGCCA	CATCCTGCACGCTACTTGGCTG
Pig24Fw:Pig41Rv	AGGACCGGCTAATTCCGTGCCA	ACCTTCCGTATTACCGCGGCTG
Pig24Fw:Pig42Rv	AGGACCGGCTAATTCCGTGCCA	AACCCATAGGGCCGTCATCCTG
Pig24Fw:Pig43Rv	AGGACCGGCTAATTCCGTGCCA	GTCCTTATTCATGCGGTACCTG
Pig24Fw:Pig44Rv	AGGACCGGCTAATTCCGTGCCA	AATTAGCCGGTCCTTATTCATG
Pig24Fw:Pig45Rv	AGGACCGGCTAATTCCGTGCCA	CGTCATCCTGCACGCTACTTGG
Pig24Fw:Pig46Rv	AGGACCGGCTAATTCCGTGCCA	ATCCTGCACGCTACTTGGCTGG
Pig24Fw:Pig47Rv	AGGACCGGCTAATTCCGTGCCA	AAGCAGTTTACAACCCATAGGG
Pig24Fw:Pig48Rv	AGGACCGGCTAATTCCGTGCCA	GGTAAGCTGCCTTCGCAATCGG
Pig24Fw:Pig49Rv	AGGACCGGCTAATTCCGTGCCA	TAGCCGGTCCTTATTCATGCGG
Pig24Fw:Pig50Rv	AGGACCGGCTAATTCCGTGCCA	AAAGCAGTTTACAACCCATAGG
Pig24Fw:Pig51Rv	AGGACCGGCTAATTCCGTGCCA	ACGCTACGGTAAGCTGCCTTCG
Pig24Fw:Pig52Rv	AGGACCGGCTAATTCCGTGCCA	CGGTAAGCTGCCTTCGCAATCG
Pig24Fw:Pig53Rv	AGGACCGGCTAATTCCGTGCCA	TTAGCCGGTCCTTATTCATGCG
Pig24Fw:Pig54Rv	AGGACCGGCTAATTCCGTGCCA	CAGTTTACAACCCATAGGGCCG
Pig24Fw:Pig55Rv	AGGACCGGCTAATTCCGTGCCA	TAAGCTGCCTTCGCAATCGGAG
Pig24Fw:Pig56Rv	AGGACCGGCTAATTCCGTGCCA	GCACGCTACTTGGCTGGTTCAG
Pig24Fw:Pig57Rv	AGGACCGGCTAATTCCGTGCCA	TACCCGCACTTTCGAGCTTCAG
Pig24Fw:Pig58Rv	AGGACCGGCTAATTCCGTGCCA	GGAGTTCTTCGTGATATCTAAG
Pig24Fw:Pig59Rv	AGGACCGGCTAATTCCGTGCCA	CTGCACGCTACTTGGCTGGTTC
Pig24Fw:Pig60Rv	AGGACCGGCTAATTCCGTGCCA	GCTGCCTTCGCAATCGGAGTTC
Pig24Fw:Pig61Rv	AGGACCGGCTAATTCCGTGCCA	GATACCCGCACTTTCGAGCTTC
Pig24Fw:Pig62Rv	AGGACCGGCTAATTCCGTGCCA	AACGCTACGGTAAGCTGCCTTC
Pig24Fw:Pig63Rv	AGGACCGGCTAATTCCGTGCCA	CGCACTTTCGAGCTTCAGCGTC
Pig24Fw:Pig64Rv	AGGACCGGCTAATTCCGTGCCA	GTTTACAACCCATAGGGCCGTC
Pig24Fw:Pig65Rv	AGGACCGGCTAATTCCGTGCCA	TTGGCTGGTTCAGACTTACGTC
Pig24Fw:Pig66Rv	AGGACCGGCTAATTCCGTGCCA	CACCACGAATTCCGCCTACCTC
Pig24Fw:Pig67Rv	AGGACCGGCTAATTCCGTGCCA	AATCGGAGTTCTTCGTGATATC
Pig24Fw:Pig68Rv	AGGACCGGCTAATTCCGTGCCA	TACAACCCATAGGGCCGTCATC
Pig24Fw:Pig69Rv	AGGACCGGCTAATTCCGTGCCA	ACGGTAAGCTGCCTTCGCAATC
Pig24Fw:Pig70Rv	AGGACCGGCTAATTCCGTGCCA	TCCTTATTCATGCGGTACCTGC
Pig24Fw:Pig71Rv	AGGACCGGCTAATTCCGTGCCA	ATTAGCCGGTCCTTATTCATGC
Pig24Fw:Pig72Rv	AGGACCGGCTAATTCCGTGCCA	GTCATCCTGCACGCTACTTGGC
Pig24Fw:Pig73Rv	AGGACCGGCTAATTCCGTGCCA	AGCAGTTTACAACCCATAGGGC
Pig24Fw:Pig74Rv	AGGACCGGCTAATTCCGTGCCA	TGATATCTAAGCATTTCACCGC
Pig24Fw:Pig75Rv	AGGACCGGCTAATTCCGTGCCA	ACCCGCACTTTCGAGCTTCAGC
Pig24Fw:Pig76Rv	AGGACCGGCTAATTCCGTGCCA	GAGTTCTTCGTGATATCTAAGC
Pig24Fw:Pig77Rv	AGGACCGGCTAATTCCGTGCCA	TGGCTGGTTCAGACTTACGTCC
Pig24Fw:Pig78Rv	AGGACCGGCTAATTCCGTGCCA	ACCACGAATTCCGCCTACCTCC
Pig24Fw:Pig79Rv	AGGACCGGCTAATTCCGTGCCA	ACAACCCATAGGGCCGTCATCC
Pig24Fw:Pig80Rv	AGGACCGGCTAATTCCGTGCCA	GCAGTTTACAACCCATAGGGCC
Pig24Fw:Pig81Rv	AGGACCGGCTAATTCCGTGCCA	GGCCTACGCTCCCTTTAAACCC
Pig24Fw:Pig82Rv	AGGACCGGCTAATTCCGTGCCA	TACACCACGAATTCCGCCTACC
Pig24Fw:Pig83Rv	AGGACCGGCTAATTCCGTGCCA	TTCAGACTTACGTCCATTGACC
Pig24Fw:Pig84Rv	AGGACCGGCTAATTCCGTGCCA	CGGCCTACGCTCCCTTTAAACC
Pig24Fw:Pig85Rv	AGGACCGGCTAATTCCGTGCCA	TATCTAAGCATTTCACCGCTAC
Pig24Fw:Pig86Rv	AGGACCGGCTAATTCCGTGCCA	GTTCAGACTTACGTCCATTGAC
Pig24Fw:Pig87Rv	AGGACCGGCTAATTCCGTGCCA	ACGCTACTTGGCTGGTTCAGAC
Pig24Fw:Pig88Rv	AGGACCGGCTAATTCCGTGCCA	TCTAAGCATTTCACCGCTACAC
Pig24Fw:Pig89Rv	AGGACCGGCTAATTCCGTGCCA	CCGGCCTACGCTCCCTTTAAAC
Pig24Fw:Pig90Rv	AGGACCGGCTAATTCCGTGCCA	AAGCCGGCCTACGCTCCCTTTA
Pig24Fw:Pig91Rv	AGGACCGGCTAATTCCGTGCCA	GCGGCATTTCACAACACGCTTA
Pig24Fw:Pig92Rv	AGGACCGGCTAATTCCGTGCCA	GCACGGAATTAGCCGGTCCTTA
Pig24Fw:Pig93Rv	AGGACCGGCTAATTCCGTGCCA	TCGGAGTTCTTCGTGATATCTA
Pig24Fw:Pig94Rv	AGGACCGGCTAATTCCGTGCCA	GCTACACCACGAATTCCGCCTA
Pig24Fw:Pig95Rv	AGGACCGGCTAATTCCGTGCCA	GCAATCGGAGTTCTTCGTGATA
Pig24Fw:Pig96Rv	AGGACCGGCTAATTCCGTGCCA	TACGCTCCCTTTAAACCCAATA
Pig24Fw:Pig97Rv	AGGACCGGCTAATTCCGTGCCA	GGTTCAGACTTACGTCCATTGA
Pig24Fw:Pig98Rv	AGGACCGGCTAATTCCGTGCCA	TCGCAATCGGAGTTCTTCGTGA
Pig24Fw:Pig99Rv	AGGACCGGCTAATTCCGTGCCA	GTAAGCTGCCTTCGCAATCGGA
Pig24Fw:Pig100Rv	AGGACCGGCTAATTCCGTGCCA	CACGCTACTTGGCTGGTTCAGA
Pig24Fw:Pig101Rv	AGGACCGGCTAATTCCGTGCCA	TGCACGCTACTTGGCTGGTTCA
Pig24Fw:Pig102Rv	AGGACCGGCTAATTCCGTGCCA	ATACCCGCACTTTCGAGCTTCA
Pig24Fw:Pig103Rv	AGGACCGGCTAATTCCGTGCCA	GCACTTTCGAGCTTCAGCGTCA
Pig24Fw:Pig104Rv	AGGACCGGCTAATTCCGTGCCA	TTTACAACCCATAGGGCCGTCA
Pig24Fw:Pig105Rv	AGGACCGGCTAATTCCGTGCCA	CCTTATTCATGCGGTACCTGCA
Pig24Fw:Pig106Rv	AGGACCGGCTAATTCCGTGCCA	GCTACGGTAAGCTGCCTTCGCA
Pig24Fw:Pig107Rv	AGGACCGGCTAATTCCGTGCCA	GGCTGGTTCAGACTTACGTCCA
Pig24Fw:Pig108Rv	AGGACCGGCTAATTCCGTGCCA	GCCTACGCTCCCTTTAAACCCA
Pig24Fw:Pig109Rv	AGGACCGGCTAATTCCGTGCCA	TCAGACTTACGTCCATTGACCA
Pig24Fw:Pig110Rv	AGGACCGGCTAATTCCGTGCCA	ATCTAAGCATTTCACCGCTACA
Pig24Fw:Pig111Rv	AGGACCGGCTAATTCCGTGCCA	AGCCGGCCTACGCTCCCTTTAA
Pig24Fw:Pig112Rv	AGGACCGGCTAATTCCGTGCCA	CGGCATTTCACAACACGCTTAA
Pig24Fw:Pig113Rv	AGGACCGGCTAATTCCGTGCCA	CGGAGTTCTTCGTGATATCTAA
Pig24Fw:Pig114Rv	AGGACCGGCTAATTCCGTGCCA	ACGCTCCCTTTAAACCCAATAA
Pig24Fw:Pig115Rv	AGGACCGGCTAATTCCGTGCCA	CTTATTCATGCGGTACCTGCAA
Pig24Fw:Pig116Rv	AGGACCGGCTAATTCCGTGCCA	CTACGGTAAGCTGCCTTCGCAA
Pig24Fw:Pig117Rv	AGGACCGGCTAATTCCGTGCCA	CCTACGCTCCCTTTAAACCCAA
Pig24Fw:Pig118Rv	AGGACCGGCTAATTCCGTGCCA	CAGACTTACGTCCATTGACCAA
Pig24Fw:Pig119Rv	AGGACCGGCTAATTCCGTGCCA	GCCGGCCTACGCTCCCTTTAAA
Pig24Fw:Pig120Rv	AGGACCGGCTAATTCCGTGCCA	GGCATTTCACAACACGCTTAAA
Pig24Fw:Pig121Rv	AGGACCGGCTAATTCCGTGCCA	TTATTCATGCGGTACCTGCAAA
Pig25Fw:Pig1Rv	AGGATGACGGCCCTATGGGTTG	CCTGCACGCTACTTGGCTGGTT
Pig25Fw:Pig2Rv	AGGATGACGGCCCTATGGGTTG	AGCTGCCTTCGCAATCGGAGTT
Pig25Fw:Pig3Rv	AGGATGACGGCCCTATGGGTTG	TGCCTTCGCAATCGGAGTTCTT
Pig25Fw:Pig4Rv	AGGATGACGGCCCTATGGGTTG	CGCGGCATTTCACAACACGCTT
Pig25Fw:Pig5Rv	AGGATGACGGCCCTATGGGTTG	CGATACCCGCACTTTCGAGCTT
Pig25Fw:Pig6Rv	AGGATGACGGCCCTATGGGTTG	GGCACGGAATTAGCCGGTCCTT
Pig25Fw:Pig7Rv	AGGATGACGGCCCTATGGGTTG	TAACGCTACGGTAAGCTGCCTT
Pig25Fw:Pig8Rv	AGGATGACGGCCCTATGGGTTG	GCCGTCATCCTGCACGCTACTT
Pig25Fw:Pig9Rv	AGGATGACGGCCCTATGGGTTG	ACGGAATTAGCCGGTCCTTATT
Pig25Fw:Pig10Rv	AGGATGACGGCCCTATGGGTTG	CTGGTTCAGACTTACGTCCATT
Pig25Fw:Pig11Rv	AGGATGACGGCCCTATGGGTTG	TCCTGCACGCTACTTGGCTGGT
Pig25Fw:Pig12Rv	AGGATGACGGCCCTATGGGTTG	TGCTGGCACGGAATTAGCCGGT
Pig25Fw:Pig13Rv	AGGATGACGGCCCTATGGGTTG	CCGCACTTTCGAGCTTCAGCGT
Pig25Fw:Pig14Rv	AGGATGACGGCCCTATGGGTTG	AGTTTACAACCCATAGGGCCGT
Pig25Fw:Pig15Rv	AGGATGACGGCCCTATGGGTTG	CTTGGCTGGTTCAGACTTACGT
Pig25Fw:Pig16Rv	AGGATGACGGCCCTATGGGTTG	AAGCTGCCTTCGCAATCGGAGT
Pig25Fw:Pig17Rv	AGGATGACGGCCCTATGGGTTG	CTGCCTTCGCAATCGGAGTTCT
Pig25Fw:Pig18Rv	AGGATGACGGCCCTATGGGTTG	ATCGGAGTTCTTCGTGATATCT
Pig25Fw:Pig19Rv	AGGATGACGGCCCTATGGGTTG	CTTCCGTATTACCGCGGCTGCT
Pig25Fw:Pig20Rv	AGGATGACGGCCCTATGGGTTG	TCATCCTGCACGCTACTTGGCT
Pig25Fw:Pig21Rv	AGGATGACGGCCCTATGGGTTG	GACCTTCCGTATTACCGCGGCT
Pig25Fw:Pig22Rv	AGGATGACGGCCCTATGGGTTG	GATATCTAAGCATTTCACCGCT
Pig25Fw:Pig23Rv	AGGATGACGGCCCTATGGGTTG	CCGCGGCATTTCACAACACGCT
Pig25Fw:Pig24Rv	AGGATGACGGCCCTATGGGTTG	TGGCACGGAATTAGCCGGTCCT
Pig25Fw:Pig25Rv	AGGATGACGGCCCTATGGGTTG	CAACCCATAGGGCCGTCATCCT
Pig25Fw:Pig26Rv	AGGATGACGGCCCTATGGGTTG	CGCTACACCACGAATTCCGCCT
Pig25Fw:Pig27Rv	AGGATGACGGCCCTATGGGTTG	GGTCCTTATTCATGCGGTACCT
Pig25Fw:Pig28Rv	AGGATGACGGCCCTATGGGTTG	ACACCACGAATTCCGCCTACCT
Pig25Fw:Pig29Rv	AGGATGACGGCCCTATGGGTTG	CGCTACTTGGCTGGTTCAGACT
Pig25Fw:Pig30Rv	AGGATGACGGCCCTATGGGTTG	CACGGAATTAGCCGGTCCTTAT
Pig25Fw:Pig31Rv	AGGATGACGGCCCTATGGGTTG	CAATCGGAGTTCTTCGTGATAT
Pig25Fw:Pig32Rv	AGGATGACGGCCCTATGGGTTG	CGCAATCGGAGTTCTTCGTGAT
Pig25Fw:Pig33Rv	AGGATGACGGCCCTATGGGTTG	TTACAACCCATAGGGCCGTCAT
Pig25Fw:Pig34Rv	AGGATGACGGCCCTATGGGTTG	GCTGGTTCAGACTTACGTCCAT
Pig25Fw:Pig35Rv	AGGATGACGGCCCTATGGGTTG	TACGGTAAGCTGCCTTCGCAAT
Pig25Fw:Pig36Rv	AGGATGACGGCCCTATGGGTTG	CTACGCTCCCTTTAAACCCAAT
Pig25Fw:Pig37Rv	AGGATGACGGCCCTATGGGTTG	CCGTCATCCTGCACGCTACTTG
Pig25Fw:Pig38Rv	AGGATGACGGCCCTATGGGTTG	TGGTTCAGACTTACGTCCATTG
Pig25Fw:Pig39Rv	AGGATGACGGCCCTATGGGTTG	TTCCGTATTACCGCGGCTGCTG
Pig25Fw:Pig40Rv	AGGATGACGGCCCTATGGGTTG	CATCCTGCACGCTACTTGGCTG
Pig25Fw:Pig41Rv	AGGATGACGGCCCTATGGGTTG	ACCTTCCGTATTACCGCGGCTG
Pig25Fw:Pig42Rv	AGGATGACGGCCCTATGGGTTG	AACCCATAGGGCCGTCATCCTG
Pig25Fw:Pig43Rv	AGGATGACGGCCCTATGGGTTG	GTCCTTATTCATGCGGTACCTG
Pig25Fw:Pig44Rv	AGGATGACGGCCCTATGGGTTG	AATTAGCCGGTCCTTATTCATG
Pig25Fw:Pig45Rv	AGGATGACGGCCCTATGGGTTG	CGTCATCCTGCACGCTACTTGG
Pig25Fw:Pig46Rv	AGGATGACGGCCCTATGGGTTG	ATCCTGCACGCTACTTGGCTGG
Pig25Fw:Pig47Rv	AGGATGACGGCCCTATGGGTTG	AAGCAGTTTACAACCCATAGGG
Pig25Fw:Pig48Rv	AGGATGACGGCCCTATGGGTTG	GGTAAGCTGCCTTCGCAATCGG
Pig25Fw:Pig49Rv	AGGATGACGGCCCTATGGGTTG	TAGCCGGTCCTTATTCATGCGG
Pig25Fw:Pig50Rv	AGGATGACGGCCCTATGGGTTG	AAAGCAGTTTACAACCCATAGG
Pig25Fw:Pig51Rv	AGGATGACGGCCCTATGGGTTG	ACGCTACGGTAAGCTGCCTTCG
Pig25Fw:Pig52Rv	AGGATGACGGCCCTATGGGTTG	CGGTAAGCTGCCTTCGCAATCG
Pig25Fw:Pig53Rv	AGGATGACGGCCCTATGGGTTG	TTAGCCGGTCCTTATTCATGCG
Pig25Fw:Pig54Rv	AGGATGACGGCCCTATGGGTTG	CAGTTTACAACCCATAGGGCCG
Pig25Fw:Pig55Rv	AGGATGACGGCCCTATGGGTTG	TAAGCTGCCTTCGCAATCGGAG
Pig25Fw:Pig56Rv	AGGATGACGGCCCTATGGGTTG	GCACGCTACTTGGCTGGTTCAG
Pig25Fw:Pig57Rv	AGGATGACGGCCCTATGGGTTG	TACCCGCACTTTCGAGCTTCAG
Pig25Fw:Pig58Rv	AGGATGACGGCCCTATGGGTTG	GGAGTTCTTCGTGATATCTAAG
Pig25Fw:Pig59Rv	AGGATGACGGCCCTATGGGTTG	CTGCACGCTACTTGGCTGGTTC
Pig25Fw:Pig60Rv	AGGATGACGGCCCTATGGGTTG	GCTGCCTTCGCAATCGGAGTTC
Pig25Fw:Pig61Rv	AGGATGACGGCCCTATGGGTTG	GATACCCGCACTTTCGAGCTTC
Pig25Fw:Pig62Rv	AGGATGACGGCCCTATGGGTTG	AACGCTACGGTAAGCTGCCTTC
Pig25Fw:Pig63Rv	AGGATGACGGCCCTATGGGTTG	CGCACTTTCGAGCTTCAGCGTC
Pig25Fw:Pig64Rv	AGGATGACGGCCCTATGGGTTG	GTTTACAACCCATAGGGCCGTC
Pig25Fw:Pig65Rv	AGGATGACGGCCCTATGGGTTG	TTGGCTGGTTCAGACTTACGTC
Pig25Fw:Pig66Rv	AGGATGACGGCCCTATGGGTTG	CACCACGAATTCCGCCTACCTC
Pig25Fw:Pig67Rv	AGGATGACGGCCCTATGGGTTG	AATCGGAGTTCTTCGTGATATC
Pig25Fw:Pig68Rv	AGGATGACGGCCCTATGGGTTG	TACAACCCATAGGGCCGTCATC
Pig25Fw:Pig69Rv	AGGATGACGGCCCTATGGGTTG	ACGGTAAGCTGCCTTCGCAATC
Pig25Fw:Pig70Rv	AGGATGACGGCCCTATGGGTTG	TCCTTATTCATGCGGTACCTGC
Pig25Fw:Pig71Rv	AGGATGACGGCCCTATGGGTTG	ATTAGCCGGTCCTTATTCATGC
Pig25Fw:Pig72Rv	AGGATGACGGCCCTATGGGTTG	GTCATCCTGCACGCTACTTGGC
Pig25Fw:Pig73Rv	AGGATGACGGCCCTATGGGTTG	AGCAGTTTACAACCCATAGGGC
Pig25Fw:Pig74Rv	AGGATGACGGCCCTATGGGTTG	TGATATCTAAGCATTTCACCGC
Pig25Fw:Pig75Rv	AGGATGACGGCCCTATGGGTTG	ACCCGCACTTTCGAGCTTCAGC
Pig25Fw:Pig76Rv	AGGATGACGGCCCTATGGGTTG	GAGTTCTTCGTGATATCTAAGC
Pig25Fw:Pig77Rv	AGGATGACGGCCCTATGGGTTG	TGGCTGGTTCAGACTTACGTCC
Pig25Fw:Pig78Rv	AGGATGACGGCCCTATGGGTTG	ACCACGAATTCCGCCTACCTCC
Pig25Fw:Pig79Rv	AGGATGACGGCCCTATGGGTTG	ACAACCCATAGGGCCGTCATCC
Pig25Fw:Pig80Rv	AGGATGACGGCCCTATGGGTTG	GCAGTTTACAACCCATAGGGCC
Pig25Fw:Pig81Rv	AGGATGACGGCCCTATGGGTTG	GGCCTACGCTCCCTTTAAACCC
Pig25Fw:Pig82Rv	AGGATGACGGCCCTATGGGTTG	TACACCACGAATTCCGCCTACC
Pig25Fw:Pig83Rv	AGGATGACGGCCCTATGGGTTG	TTCAGACTTACGTCCATTGACC
Pig25Fw:Pig84Rv	AGGATGACGGCCCTATGGGTTG	CGGCCTACGCTCCCTTTAAACC
Pig25Fw:Pig85Rv	AGGATGACGGCCCTATGGGTTG	TATCTAAGCATTTCACCGCTAC
Pig25Fw:Pig86Rv	AGGATGACGGCCCTATGGGTTG	GTTCAGACTTACGTCCATTGAC
Pig25Fw:Pig87Rv	AGGATGACGGCCCTATGGGTTG	ACGCTACTTGGCTGGTTCAGAC
Pig25Fw:Pig88Rv	AGGATGACGGCCCTATGGGTTG	TCTAAGCATTTCACCGCTACAC
Pig25Fw:Pig89Rv	AGGATGACGGCCCTATGGGTTG	CCGGCCTACGCTCCCTTTAAAC
Pig25Fw:Pig90Rv	AGGATGACGGCCCTATGGGTTG	AAGCCGGCCTACGCTCCCTTTA
Pig25Fw:Pig91Rv	AGGATGACGGCCCTATGGGTTG	GCGGCATTTCACAACACGCTTA
Pig25Fw:Pig92Rv	AGGATGACGGCCCTATGGGTTG	GCACGGAATTAGCCGGTCCTTA
Pig25Fw:Pig93Rv	AGGATGACGGCCCTATGGGTTG	TCGGAGTTCTTCGTGATATCTA
Pig25Fw:Pig94Rv	AGGATGACGGCCCTATGGGTTG	GCTACACCACGAATTCCGCCTA
Pig25Fw:Pig95Rv	AGGATGACGGCCCTATGGGTTG	GCAATCGGAGTTCTTCGTGATA
Pig25Fw:Pig96Rv	AGGATGACGGCCCTATGGGTTG	TACGCTCCCTTTAAACCCAATA
Pig25Fw:Pig97Rv	AGGATGACGGCCCTATGGGTTG	GGTTCAGACTTACGTCCATTGA
Pig25Fw:Pig98Rv	AGGATGACGGCCCTATGGGTTG	TCGCAATCGGAGTTCTTCGTGA
Pig25Fw:Pig99Rv	AGGATGACGGCCCTATGGGTTG	GTAAGCTGCCTTCGCAATCGGA
Pig25Fw:Pig100Rv	AGGATGACGGCCCTATGGGTTG	CACGCTACTTGGCTGGTTCAGA
Pig25Fw:Pig101Rv	AGGATGACGGCCCTATGGGTTG	TGCACGCTACTTGGCTGGTTCA
Pig25Fw:Pig102Rv	AGGATGACGGCCCTATGGGTTG	ATACCCGCACTTTCGAGCTTCA
Pig25Fw:Pig103Rv	AGGATGACGGCCCTATGGGTTG	GCACTTTCGAGCTTCAGCGTCA
Pig25Fw:Pig104Rv	AGGATGACGGCCCTATGGGTTG	TTTACAACCCATAGGGCCGTCA
Pig25Fw:Pig105Rv	AGGATGACGGCCCTATGGGTTG	CCTTATTCATGCGGTACCTGCA
Pig25Fw:Pig106Rv	AGGATGACGGCCCTATGGGTTG	GCTACGGTAAGCTGCCTTCGCA
Pig25Fw:Pig107Rv	AGGATGACGGCCCTATGGGTTG	GGCTGGTTCAGACTTACGTCCA
Pig25Fw:Pig108Rv	AGGATGACGGCCCTATGGGTTG	GCCTACGCTCCCTTTAAACCCA
Pig25Fw:Pig109Rv	AGGATGACGGCCCTATGGGTTG	TCAGACTTACGTCCATTGACCA
Pig25Fw:Pig110Rv	AGGATGACGGCCCTATGGGTTG	ATCTAAGCATTTCACCGCTACA
Pig25Fw:Pig111Rv	AGGATGACGGCCCTATGGGTTG	AGCCGGCCTACGCTCCCTTTAA
Pig25Fw:Pig112Rv	AGGATGACGGCCCTATGGGTTG	CGGCATTTCACAACACGCTTAA
Pig25Fw:Pig113Rv	AGGATGACGGCCCTATGGGTTG	CGGAGTTCTTCGTGATATCTAA
Pig25Fw:Pig114Rv	AGGATGACGGCCCTATGGGTTG	ACGCTCCCTTTAAACCCAATAA
Pig25Fw:Pig115Rv	AGGATGACGGCCCTATGGGTTG	CTTATTCATGCGGTACCTGCAA
Pig25Fw:Pig116Rv	AGGATGACGGCCCTATGGGTTG	CTACGGTAAGCTGCCTTCGCAA
Pig25Fw:Pig117Rv	AGGATGACGGCCCTATGGGTTG	CCTACGCTCCCTTTAAACCCAA
Pig25Fw:Pig118Rv	AGGATGACGGCCCTATGGGTTG	CAGACTTACGTCCATTGACCAA
Pig25Fw:Pig119Rv	AGGATGACGGCCCTATGGGTTG	GCCGGCCTACGCTCCCTTTAAA
Pig25Fw:Pig120Rv	AGGATGACGGCCCTATGGGTTG	GGCATTTCACAACACGCTTAAA
Pig25Fw:Pig121Rv	AGGATGACGGCCCTATGGGTTG	TTATTCATGCGGTACCTGCAAA
Pig26Fw:Pig1Rv	AGGCGGAATTCGTGGTGTAGCG	CCTGCACGCTACTTGGCTGGTT
Pig26Fw:Pig2Rv	AGGCGGAATTCGTGGTGTAGCG	AGCTGCCTTCGCAATCGGAGTT
Pig26Fw:Pig3Rv	AGGCGGAATTCGTGGTGTAGCG	TGCCTTCGCAATCGGAGTTCTT
Pig26Fw:Pig4Rv	AGGCGGAATTCGTGGTGTAGCG	CGCGGCATTTCACAACACGCTT
Pig26Fw:Pig5Rv	AGGCGGAATTCGTGGTGTAGCG	CGATACCCGCACTTTCGAGCTT
Pig26Fw:Pig6Rv	AGGCGGAATTCGTGGTGTAGCG	GGCACGGAATTAGCCGGTCCTT
Pig26Fw:Pig7Rv	AGGCGGAATTCGTGGTGTAGCG	TAACGCTACGGTAAGCTGCCTT
Pig26Fw:Pig8Rv	AGGCGGAATTCGTGGTGTAGCG	GCCGTCATCCTGCACGCTACTT
Pig26Fw:Pig9Rv	AGGCGGAATTCGTGGTGTAGCG	ACGGAATTAGCCGGTCCTTATT
Pig26Fw:Pig10Rv	AGGCGGAATTCGTGGTGTAGCG	CTGGTTCAGACTTACGTCCATT
Pig26Fw:Pig11Rv	AGGCGGAATTCGTGGTGTAGCG	TCCTGCACGCTACTTGGCTGGT
Pig26Fw:Pig12Rv	AGGCGGAATTCGTGGTGTAGCG	TGCTGGCACGGAATTAGCCGGT
Pig26Fw:Pig13Rv	AGGCGGAATTCGTGGTGTAGCG	CCGCACTTTCGAGCTTCAGCGT
Pig26Fw:Pig14Rv	AGGCGGAATTCGTGGTGTAGCG	AGTTTACAACCCATAGGGCCGT
Pig26Fw:Pig15Rv	AGGCGGAATTCGTGGTGTAGCG	CTTGGCTGGTTCAGACTTACGT
Pig26Fw:Pig16Rv	AGGCGGAATTCGTGGTGTAGCG	AAGCTGCCTTCGCAATCGGAGT
Pig26Fw:Pig17Rv	AGGCGGAATTCGTGGTGTAGCG	CTGCCTTCGCAATCGGAGTTCT
Pig26Fw:Pig18Rv	AGGCGGAATTCGTGGTGTAGCG	ATCGGAGTTCTTCGTGATATCT
Pig26Fw:Pig19Rv	AGGCGGAATTCGTGGTGTAGCG	CTTCCGTATTACCGCGGCTGCT
Pig26Fw:Pig20Rv	AGGCGGAATTCGTGGTGTAGCG	TCATCCTGCACGCTACTTGGCT
Pig26Fw:Pig21Rv	AGGCGGAATTCGTGGTGTAGCG	GACCTTCCGTATTACCGCGGCT
Pig26Fw:Pig22Rv	AGGCGGAATTCGTGGTGTAGCG	GATATCTAAGCATTTCACCGCT
Pig26Fw:Pig23Rv	AGGCGGAATTCGTGGTGTAGCG	CCGCGGCATTTCACAACACGCT
Pig26Fw:Pig24Rv	AGGCGGAATTCGTGGTGTAGCG	TGGCACGGAATTAGCCGGTCCT
Pig26Fw:Pig25Rv	AGGCGGAATTCGTGGTGTAGCG	CAACCCATAGGGCCGTCATCCT
Pig26Fw:Pig26Rv	AGGCGGAATTCGTGGTGTAGCG	CGCTACACCACGAATTCCGCCT
Pig26Fw:Pig27Rv	AGGCGGAATTCGTGGTGTAGCG	GGTCCTTATTCATGCGGTACCT
Pig26Fw:Pig28Rv	AGGCGGAATTCGTGGTGTAGCG	ACACCACGAATTCCGCCTACCT
Pig26Fw:Pig29Rv	AGGCGGAATTCGTGGTGTAGCG	CGCTACTTGGCTGGTTCAGACT
Pig26Fw:Pig30Rv	AGGCGGAATTCGTGGTGTAGCG	CACGGAATTAGCCGGTCCTTAT
Pig26Fw:Pig31Rv	AGGCGGAATTCGTGGTGTAGCG	CAATCGGAGTTCTTCGTGATAT
Pig26Fw:Pig32Rv	AGGCGGAATTCGTGGTGTAGCG	CGCAATCGGAGTTCTTCGTGAT
Pig26Fw:Pig33Rv	AGGCGGAATTCGTGGTGTAGCG	TTACAACCCATAGGGCCGTCAT
Pig26Fw:Pig34Rv	AGGCGGAATTCGTGGTGTAGCG	GCTGGTTCAGACTTACGTCCAT
Pig26Fw:Pig35Rv	AGGCGGAATTCGTGGTGTAGCG	TACGGTAAGCTGCCTTCGCAAT
Pig26Fw:Pig36Rv	AGGCGGAATTCGTGGTGTAGCG	CTACGCTCCCTTTAAACCCAAT
Pig26Fw:Pig37Rv	AGGCGGAATTCGTGGTGTAGCG	CCGTCATCCTGCACGCTACTTG
Pig26Fw:Pig38Rv	AGGCGGAATTCGTGGTGTAGCG	TGGTTCAGACTTACGTCCATTG
Pig26Fw:Pig39Rv	AGGCGGAATTCGTGGTGTAGCG	TTCCGTATTACCGCGGCTGCTG
Pig26Fw:Pig40Rv	AGGCGGAATTCGTGGTGTAGCG	CATCCTGCACGCTACTTGGCTG
Pig26Fw:Pig41Rv	AGGCGGAATTCGTGGTGTAGCG	ACCTTCCGTATTACCGCGGCTG
Pig26Fw:Pig42Rv	AGGCGGAATTCGTGGTGTAGCG	AACCCATAGGGCCGTCATCCTG
Pig26Fw:Pig43Rv	AGGCGGAATTCGTGGTGTAGCG	GTCCTTATTCATGCGGTACCTG
Pig26Fw:Pig44Rv	AGGCGGAATTCGTGGTGTAGCG	AATTAGCCGGTCCTTATTCATG
Pig26Fw:Pig45Rv	AGGCGGAATTCGTGGTGTAGCG	CGTCATCCTGCACGCTACTTGG
Pig26Fw:Pig46Rv	AGGCGGAATTCGTGGTGTAGCG	ATCCTGCACGCTACTTGGCTGG
Pig26Fw:Pig47Rv	AGGCGGAATTCGTGGTGTAGCG	AAGCAGTTTACAACCCATAGGG
Pig26Fw:Pig48Rv	AGGCGGAATTCGTGGTGTAGCG	GGTAAGCTGCCTTCGCAATCGG
Pig26Fw:Pig49Rv	AGGCGGAATTCGTGGTGTAGCG	TAGCCGGTCCTTATTCATGCGG
Pig26Fw:Pig50Rv	AGGCGGAATTCGTGGTGTAGCG	AAAGCAGTTTACAACCCATAGG
Pig26Fw:Pig51Rv	AGGCGGAATTCGTGGTGTAGCG	ACGCTACGGTAAGCTGCCTTCG
Pig26Fw:Pig52Rv	AGGCGGAATTCGTGGTGTAGCG	CGGTAAGCTGCCTTCGCAATCG
Pig26Fw:Pig53Rv	AGGCGGAATTCGTGGTGTAGCG	TTAGCCGGTCCTTATTCATGCG
Pig26Fw:Pig54Rv	AGGCGGAATTCGTGGTGTAGCG	CAGTTTACAACCCATAGGGCCG
Pig26Fw:Pig55Rv	AGGCGGAATTCGTGGTGTAGCG	TAAGCTGCCTTCGCAATCGGAG
Pig26Fw:Pig56Rv	AGGCGGAATTCGTGGTGTAGCG	GCACGCTACTTGGCTGGTTCAG
Pig26Fw:Pig57Rv	AGGCGGAATTCGTGGTGTAGCG	TACCCGCACTTTCGAGCTTCAG
Pig26Fw:Pig58Rv	AGGCGGAATTCGTGGTGTAGCG	GGAGTTCTTCGTGATATCTAAG
Pig26Fw:Pig59Rv	AGGCGGAATTCGTGGTGTAGCG	CTGCACGCTACTTGGCTGGTTC
Pig26Fw:Pig60Rv	AGGCGGAATTCGTGGTGTAGCG	GCTGCCTTCGCAATCGGAGTTC
Pig26Fw:Pig61Rv	AGGCGGAATTCGTGGTGTAGCG	GATACCCGCACTTTCGAGCTTC
Pig26Fw:Pig62Rv	AGGCGGAATTCGTGGTGTAGCG	AACGCTACGGTAAGCTGCCTTC
Pig26Fw:Pig63Rv	AGGCGGAATTCGTGGTGTAGCG	CGCACTTTCGAGCTTCAGCGTC
Pig26Fw:Pig64Rv	AGGCGGAATTCGTGGTGTAGCG	GTTTACAACCCATAGGGCCGTC
Pig26Fw:Pig65Rv	AGGCGGAATTCGTGGTGTAGCG	TTGGCTGGTTCAGACTTACGTC
Pig26Fw:Pig66Rv	AGGCGGAATTCGTGGTGTAGCG	CACCACGAATTCCGCCTACCTC
Pig26Fw:Pig67Rv	AGGCGGAATTCGTGGTGTAGCG	AATCGGAGTTCTTCGTGATATC
Pig26Fw:Pig68Rv	AGGCGGAATTCGTGGTGTAGCG	TACAACCCATAGGGCCGTCATC
Pig26Fw:Pig69Rv	AGGCGGAATTCGTGGTGTAGCG	ACGGTAAGCTGCCTTCGCAATC
Pig26Fw:Pig70Rv	AGGCGGAATTCGTGGTGTAGCG	TCCTTATTCATGCGGTACCTGC
Pig26Fw:Pig71Rv	AGGCGGAATTCGTGGTGTAGCG	ATTAGCCGGTCCTTATTCATGC
Pig26Fw:Pig72Rv	AGGCGGAATTCGTGGTGTAGCG	GTCATCCTGCACGCTACTTGGC
Pig26Fw:Pig73Rv	AGGCGGAATTCGTGGTGTAGCG	AGCAGTTTACAACCCATAGGGC
Pig26Fw:Pig74Rv	AGGCGGAATTCGTGGTGTAGCG	TGATATCTAAGCATTTCACCGC
Pig26Fw:Pig75Rv	AGGCGGAATTCGTGGTGTAGCG	ACCCGCACTTTCGAGCTTCAGC
Pig26Fw:Pig76Rv	AGGCGGAATTCGTGGTGTAGCG	GAGTTCTTCGTGATATCTAAGC
Pig26Fw:Pig77Rv	AGGCGGAATTCGTGGTGTAGCG	TGGCTGGTTCAGACTTACGTCC
Pig26Fw:Pig78Rv	AGGCGGAATTCGTGGTGTAGCG	ACCACGAATTCCGCCTACCTCC
Pig26Fw:Pig79Rv	AGGCGGAATTCGTGGTGTAGCG	ACAACCCATAGGGCCGTCATCC
Pig26Fw:Pig80Rv	AGGCGGAATTCGTGGTGTAGCG	GCAGTTTACAACCCATAGGGCC
Pig26Fw:Pig81Rv	AGGCGGAATTCGTGGTGTAGCG	GGCCTACGCTCCCTTTAAACCC
Pig26Fw:Pig82Rv	AGGCGGAATTCGTGGTGTAGCG	TACACCACGAATTCCGCCTACC
Pig26Fw:Pig83Rv	AGGCGGAATTCGTGGTGTAGCG	TTCAGACTTACGTCCATTGACC
Pig26Fw:Pig84Rv	AGGCGGAATTCGTGGTGTAGCG	CGGCCTACGCTCCCTTTAAACC
Pig26Fw:Pig85Rv	AGGCGGAATTCGTGGTGTAGCG	TATCTAAGCATTTCACCGCTAC
Pig26Fw:Pig86Rv	AGGCGGAATTCGTGGTGTAGCG	GTTCAGACTTACGTCCATTGAC
Pig26Fw:Pig87Rv	AGGCGGAATTCGTGGTGTAGCG	ACGCTACTTGGCTGGTTCAGAC
Pig26Fw:Pig88Rv	AGGCGGAATTCGTGGTGTAGCG	TCTAAGCATTTCACCGCTACAC
Pig26Fw:Pig89Rv	AGGCGGAATTCGTGGTGTAGCG	CCGGCCTACGCTCCCTTTAAAC
Pig26Fw:Pig90Rv	AGGCGGAATTCGTGGTGTAGCG	AAGCCGGCCTACGCTCCCTTTA
Pig26Fw:Pig91Rv	AGGCGGAATTCGTGGTGTAGCG	GCGGCATTTCACAACACGCTTA
Pig26Fw:Pig92Rv	AGGCGGAATTCGTGGTGTAGCG	GCACGGAATTAGCCGGTCCTTA
Pig26Fw:Pig93Rv	AGGCGGAATTCGTGGTGTAGCG	TCGGAGTTCTTCGTGATATCTA
Pig26Fw:Pig94Rv	AGGCGGAATTCGTGGTGTAGCG	GCTACACCACGAATTCCGCCTA
Pig26Fw:Pig95Rv	AGGCGGAATTCGTGGTGTAGCG	GCAATCGGAGTTCTTCGTGATA
Pig26Fw:Pig96Rv	AGGCGGAATTCGTGGTGTAGCG	TACGCTCCCTTTAAACCCAATA
Pig26Fw:Pig97Rv	AGGCGGAATTCGTGGTGTAGCG	GGTTCAGACTTACGTCCATTGA
Pig26Fw:Pig98Rv	AGGCGGAATTCGTGGTGTAGCG	TCGCAATCGGAGTTCTTCGTGA
Pig26Fw:Pig99Rv	AGGCGGAATTCGTGGTGTAGCG	GTAAGCTGCCTTCGCAATCGGA
Pig26Fw:Pig100Rv	AGGCGGAATTCGTGGTGTAGCG	CACGCTACTTGGCTGGTTCAGA
Pig26Fw:Pig101Rv	AGGCGGAATTCGTGGTGTAGCG	TGCACGCTACTTGGCTGGTTCA
Pig26Fw:Pig102Rv	AGGCGGAATTCGTGGTGTAGCG	ATACCCGCACTTTCGAGCTTCA
Pig26Fw:Pig103Rv	AGGCGGAATTCGTGGTGTAGCG	GCACTTTCGAGCTTCAGCGTCA
Pig26Fw:Pig104Rv	AGGCGGAATTCGTGGTGTAGCG	TTTACAACCCATAGGGCCGTCA
Pig26Fw:Pig105Rv	AGGCGGAATTCGTGGTGTAGCG	CCTTATTCATGCGGTACCTGCA
Pig26Fw:Pig106Rv	AGGCGGAATTCGTGGTGTAGCG	GCTACGGTAAGCTGCCTTCGCA
Pig26Fw:Pig107Rv	AGGCGGAATTCGTGGTGTAGCG	GGCTGGTTCAGACTTACGTCCA
Pig26Fw:Pig108Rv	AGGCGGAATTCGTGGTGTAGCG	GCCTACGCTCCCTTTAAACCCA
Pig26Fw:Pig109Rv	AGGCGGAATTCGTGGTGTAGCG	TCAGACTTACGTCCATTGACCA
Pig26Fw:Pig110Rv	AGGCGGAATTCGTGGTGTAGCG	ATCTAAGCATTTCACCGCTACA
Pig26Fw:Pig111Rv	AGGCGGAATTCGTGGTGTAGCG	AGCCGGCCTACGCTCCCTTTAA
Pig26Fw:Pig112Rv	AGGCGGAATTCGTGGTGTAGCG	CGGCATTTCACAACACGCTTAA
Pig26Fw:Pig113Rv	AGGCGGAATTCGTGGTGTAGCG	CGGAGTTCTTCGTGATATCTAA
Pig26Fw:Pig114Rv	AGGCGGAATTCGTGGTGTAGCG	ACGCTCCCTTTAAACCCAATAA
Pig26Fw:Pig115Rv	AGGCGGAATTCGTGGTGTAGCG	CTTATTCATGCGGTACCTGCAA
Pig26Fw:Pig116Rv	AGGCGGAATTCGTGGTGTAGCG	CTACGGTAAGCTGCCTTCGCAA
Pig26Fw:Pig117Rv	AGGCGGAATTCGTGGTGTAGCG	CCTACGCTCCCTTTAAACCCAA
Pig26Fw:Pig118Rv	AGGCGGAATTCGTGGTGTAGCG	CAGACTTACGTCCATTGACCAA
Pig26Fw:Pig119Rv	AGGCGGAATTCGTGGTGTAGCG	GCCGGCCTACGCTCCCTTTAAA
Pig26Fw:Pig120Rv	AGGCGGAATTCGTGGTGTAGCG	GGCATTTCACAACACGCTTAAA
Pig26Fw:Pig121Rv	AGGCGGAATTCGTGGTGTAGCG	TTATTCATGCGGTACCTGCAAA
Pig27Fw:Pig1Rv	AGGTACCGCATGAATAAGGACC	CCTGCACGCTACTTGGCTGGTT
Pig27Fw:Pig2Rv	AGGTACCGCATGAATAAGGACC	AGCTGCCTTCGCAATCGGAGTT
Pig27Fw:Pig3Rv	AGGTACCGCATGAATAAGGACC	TGCCTTCGCAATCGGAGTTCTT
Pig27Fw:Pig4Rv	AGGTACCGCATGAATAAGGACC	CGCGGCATTTCACAACACGCTT
Pig27Fw:Pig5Rv	AGGTACCGCATGAATAAGGACC	CGATACCCGCACTTTCGAGCTT
Pig27Fw:Pig6Rv	AGGTACCGCATGAATAAGGACC	GGCACGGAATTAGCCGGTCCTT
Pig27Fw:Pig7Rv	AGGTACCGCATGAATAAGGACC	TAACGCTACGGTAAGCTGCCTT
Pig27Fw:Pig8Rv	AGGTACCGCATGAATAAGGACC	GCCGTCATCCTGCACGCTACTT
Pig27Fw:Pig9Rv	AGGTACCGCATGAATAAGGACC	ACGGAATTAGCCGGTCCTTATT
Pig27Fw:Pig10Rv	AGGTACCGCATGAATAAGGACC	CTGGTTCAGACTTACGTCCATT
Pig27Fw:Pig11Rv	AGGTACCGCATGAATAAGGACC	TCCTGCACGCTACTTGGCTGGT
Pig27Fw:Pig12Rv	AGGTACCGCATGAATAAGGACC	TGCTGGCACGGAATTAGCCGGT
Pig27Fw:Pig13Rv	AGGTACCGCATGAATAAGGACC	CCGCACTTTCGAGCTTCAGCGT
Pig27Fw:Pig14Rv	AGGTACCGCATGAATAAGGACC	AGTTTACAACCCATAGGGCCGT
Pig27Fw:Pig15Rv	AGGTACCGCATGAATAAGGACC	CTTGGCTGGTTCAGACTTACGT
Pig27Fw:Pig16Rv	AGGTACCGCATGAATAAGGACC	AAGCTGCCTTCGCAATCGGAGT
Pig27Fw:Pig17Rv	AGGTACCGCATGAATAAGGACC	CTGCCTTCGCAATCGGAGTTCT
Pig27Fw:Pig18Rv	AGGTACCGCATGAATAAGGACC	ATCGGAGTTCTTCGTGATATCT
Pig27Fw:Pig19Rv	AGGTACCGCATGAATAAGGACC	CTTCCGTATTACCGCGGCTGCT
Pig27Fw:Pig20Rv	AGGTACCGCATGAATAAGGACC	TCATCCTGCACGCTACTTGGCT
Pig27Fw:Pig21Rv	AGGTACCGCATGAATAAGGACC	GACCTTCCGTATTACCGCGGCT
Pig27Fw:Pig22Rv	AGGTACCGCATGAATAAGGACC	GATATCTAAGCATTTCACCGCT
Pig27Fw:Pig23Rv	AGGTACCGCATGAATAAGGACC	CCGCGGCATTTCACAACACGCT
Pig27Fw:Pig24Rv	AGGTACCGCATGAATAAGGACC	TGGCACGGAATTAGCCGGTCCT
Pig27Fw:Pig25Rv	AGGTACCGCATGAATAAGGACC	CAACCCATAGGGCCGTCATCCT
Pig27Fw:Pig26Rv	AGGTACCGCATGAATAAGGACC	CGCTACACCACGAATTCCGCCT
Pig27Fw:Pig27Rv	AGGTACCGCATGAATAAGGACC	GGTCCTTATTCATGCGGTACCT
Pig27Fw:Pig28Rv	AGGTACCGCATGAATAAGGACC	ACACCACGAATTCCGCCTACCT
Pig27Fw:Pig29Rv	AGGTACCGCATGAATAAGGACC	CGCTACTTGGCTGGTTCAGACT
Pig27Fw:Pig30Rv	AGGTACCGCATGAATAAGGACC	CACGGAATTAGCCGGTCCTTAT
Pig27Fw:Pig31Rv	AGGTACCGCATGAATAAGGACC	CAATCGGAGTTCTTCGTGATAT
Pig27Fw:Pig32Rv	AGGTACCGCATGAATAAGGACC	CGCAATCGGAGTTCTTCGTGAT
Pig27Fw:Pig33Rv	AGGTACCGCATGAATAAGGACC	TTACAACCCATAGGGCCGTCAT
Pig27Fw:Pig34Rv	AGGTACCGCATGAATAAGGACC	GCTGGTTCAGACTTACGTCCAT
Pig27Fw:Pig35Rv	AGGTACCGCATGAATAAGGACC	TACGGTAAGCTGCCTTCGCAAT
Pig27Fw:Pig36Rv	AGGTACCGCATGAATAAGGACC	CTACGCTCCCTTTAAACCCAAT
Pig27Fw:Pig37Rv	AGGTACCGCATGAATAAGGACC	CCGTCATCCTGCACGCTACTTG
Pig27Fw:Pig38Rv	AGGTACCGCATGAATAAGGACC	TGGTTCAGACTTACGTCCATTG
Pig27Fw:Pig39Rv	AGGTACCGCATGAATAAGGACC	TTCCGTATTACCGCGGCTGCTG
Pig27Fw:Pig40Rv	AGGTACCGCATGAATAAGGACC	CATCCTGCACGCTACTTGGCTG
Pig27Fw:Pig41Rv	AGGTACCGCATGAATAAGGACC	ACCTTCCGTATTACCGCGGCTG
Pig27Fw:Pig42Rv	AGGTACCGCATGAATAAGGACC	AACCCATAGGGCCGTCATCCTG
Pig27Fw:Pig43Rv	AGGTACCGCATGAATAAGGACC	GTCCTTATTCATGCGGTACCTG
Pig27Fw:Pig44Rv	AGGTACCGCATGAATAAGGACC	AATTAGCCGGTCCTTATTCATG
Pig27Fw:Pig45Rv	AGGTACCGCATGAATAAGGACC	CGTCATCCTGCACGCTACTTGG
Pig27Fw:Pig46Rv	AGGTACCGCATGAATAAGGACC	ATCCTGCACGCTACTTGGCTGG
Pig27Fw:Pig47Rv	AGGTACCGCATGAATAAGGACC	AAGCAGTTTACAACCCATAGGG
Pig27Fw:Pig48Rv	AGGTACCGCATGAATAAGGACC	GGTAAGCTGCCTTCGCAATCGG
Pig27Fw:Pig49Rv	AGGTACCGCATGAATAAGGACC	TAGCCGGTCCTTATTCATGCGG
Pig27Fw:Pig50Rv	AGGTACCGCATGAATAAGGACC	AAAGCAGTTTACAACCCATAGG
Pig27Fw:Pig51Rv	AGGTACCGCATGAATAAGGACC	ACGCTACGGTAAGCTGCCTTCG
Pig27Fw:Pig52Rv	AGGTACCGCATGAATAAGGACC	CGGTAAGCTGCCTTCGCAATCG
Pig27Fw:Pig53Rv	AGGTACCGCATGAATAAGGACC	TTAGCCGGTCCTTATTCATGCG
Pig27Fw:Pig54Rv	AGGTACCGCATGAATAAGGACC	CAGTTTACAACCCATAGGGCCG
Pig27Fw:Pig55Rv	AGGTACCGCATGAATAAGGACC	TAAGCTGCCTTCGCAATCGGAG
Pig27Fw:Pig56Rv	AGGTACCGCATGAATAAGGACC	GCACGCTACTTGGCTGGTTCAG
Pig27Fw:Pig57Rv	AGGTACCGCATGAATAAGGACC	TACCCGCACTTTCGAGCTTCAG
Pig27Fw:Pig58Rv	AGGTACCGCATGAATAAGGACC	GGAGTTCTTCGTGATATCTAAG
Pig27Fw:Pig59Rv	AGGTACCGCATGAATAAGGACC	CTGCACGCTACTTGGCTGGTTC
Pig27Fw:Pig60Rv	AGGTACCGCATGAATAAGGACC	GCTGCCTTCGCAATCGGAGTTC
Pig27Fw:Pig61Rv	AGGTACCGCATGAATAAGGACC	GATACCCGCACTTTCGAGCTTC
Pig27Fw:Pig62Rv	AGGTACCGCATGAATAAGGACC	AACGCTACGGTAAGCTGCCTTC
Pig27Fw:Pig63Rv	AGGTACCGCATGAATAAGGACC	CGCACTTTCGAGCTTCAGCGTC
Pig27Fw:Pig64Rv	AGGTACCGCATGAATAAGGACC	GTTTACAACCCATAGGGCCGTC
Pig27Fw:Pig65Rv	AGGTACCGCATGAATAAGGACC	TTGGCTGGTTCAGACTTACGTC
Pig27Fw:Pig66Rv	AGGTACCGCATGAATAAGGACC	CACCACGAATTCCGCCTACCTC
Pig27Fw:Pig67Rv	AGGTACCGCATGAATAAGGACC	AATCGGAGTTCTTCGTGATATC
Pig27Fw:Pig68Rv	AGGTACCGCATGAATAAGGACC	TACAACCCATAGGGCCGTCATC
Pig27Fw:Pig69Rv	AGGTACCGCATGAATAAGGACC	ACGGTAAGCTGCCTTCGCAATC
Pig27Fw:Pig70Rv	AGGTACCGCATGAATAAGGACC	TCCTTATTCATGCGGTACCTGC
Pig27Fw:Pig71Rv	AGGTACCGCATGAATAAGGACC	ATTAGCCGGTCCTTATTCATGC
Pig27Fw:Pig72Rv	AGGTACCGCATGAATAAGGACC	GTCATCCTGCACGCTACTTGGC
Pig27Fw:Pig73Rv	AGGTACCGCATGAATAAGGACC	AGCAGTTTACAACCCATAGGGC
Pig27Fw:Pig74Rv	AGGTACCGCATGAATAAGGACC	TGATATCTAAGCATTTCACCGC
Pig27Fw:Pig75Rv	AGGTACCGCATGAATAAGGACC	ACCCGCACTTTCGAGCTTCAGC
Pig27Fw:Pig76Rv	AGGTACCGCATGAATAAGGACC	GAGTTCTTCGTGATATCTAAGC
Pig27Fw:Pig77Rv	AGGTACCGCATGAATAAGGACC	TGGCTGGTTCAGACTTACGTCC
Pig27Fw:Pig78Rv	AGGTACCGCATGAATAAGGACC	ACCACGAATTCCGCCTACCTCC
Pig27Fw:Pig79Rv	AGGTACCGCATGAATAAGGACC	ACAACCCATAGGGCCGTCATCC
Pig27Fw:Pig80Rv	AGGTACCGCATGAATAAGGACC	GCAGTTTACAACCCATAGGGCC
Pig27Fw:Pig81Rv	AGGTACCGCATGAATAAGGACC	GGCCTACGCTCCCTTTAAACCC
Pig27Fw:Pig82Rv	AGGTACCGCATGAATAAGGACC	TACACCACGAATTCCGCCTACC
Pig27Fw:Pig83Rv	AGGTACCGCATGAATAAGGACC	TTCAGACTTACGTCCATTGACC
Pig27Fw:Pig84Rv	AGGTACCGCATGAATAAGGACC	CGGCCTACGCTCCCTTTAAACC
Pig27Fw:Pig85Rv	AGGTACCGCATGAATAAGGACC	TATCTAAGCATTTCACCGCTAC
Pig27Fw:Pig86Rv	AGGTACCGCATGAATAAGGACC	GTTCAGACTTACGTCCATTGAC
Pig27Fw:Pig87Rv	AGGTACCGCATGAATAAGGACC	ACGCTACTTGGCTGGTTCAGAC
Pig27Fw:Pig88Rv	AGGTACCGCATGAATAAGGACC	TCTAAGCATTTCACCGCTACAC
Pig27Fw:Pig89Rv	AGGTACCGCATGAATAAGGACC	CCGGCCTACGCTCCCTTTAAAC
Pig27Fw:Pig90Rv	AGGTACCGCATGAATAAGGACC	AAGCCGGCCTACGCTCCCTTTA
Pig27Fw:Pig91Rv	AGGTACCGCATGAATAAGGACC	GCGGCATTTCACAACACGCTTA
Pig27Fw:Pig92Rv	AGGTACCGCATGAATAAGGACC	GCACGGAATTAGCCGGTCCTTA
Pig27Fw:Pig93Rv	AGGTACCGCATGAATAAGGACC	TCGGAGTTCTTCGTGATATCTA
Pig27Fw:Pig94Rv	AGGTACCGCATGAATAAGGACC	GCTACACCACGAATTCCGCCTA
Pig27Fw:Pig95Rv	AGGTACCGCATGAATAAGGACC	GCAATCGGAGTTCTTCGTGATA
Pig27Fw:Pig96Rv	AGGTACCGCATGAATAAGGACC	TACGCTCCCTTTAAACCCAATA
Pig27Fw:Pig97Rv	AGGTACCGCATGAATAAGGACC	GGTTCAGACTTACGTCCATTGA
Pig27Fw:Pig98Rv	AGGTACCGCATGAATAAGGACC	TCGCAATCGGAGTTCTTCGTGA
Pig27Fw:Pig99Rv	AGGTACCGCATGAATAAGGACC	GTAAGCTGCCTTCGCAATCGGA
Pig27Fw:Pig100Rv	AGGTACCGCATGAATAAGGACC	CACGCTACTTGGCTGGTTCAGA
Pig27Fw:Pig101Rv	AGGTACCGCATGAATAAGGACC	TGCACGCTACTTGGCTGGTTCA
Pig27Fw:Pig102Rv	AGGTACCGCATGAATAAGGACC	ATACCCGCACTTTCGAGCTTCA
Pig27Fw:Pig103Rv	AGGTACCGCATGAATAAGGACC	GCACTTTCGAGCTTCAGCGTCA
Pig27Fw:Pig104Rv	AGGTACCGCATGAATAAGGACC	TTTACAACCCATAGGGCCGTCA
Pig27Fw:Pig105Rv	AGGTACCGCATGAATAAGGACC	CCTTATTCATGCGGTACCTGCA
Pig27Fw:Pig106Rv	AGGTACCGCATGAATAAGGACC	GCTACGGTAAGCTGCCTTCGCA
Pig27Fw:Pig107Rv	AGGTACCGCATGAATAAGGACC	GGCTGGTTCAGACTTACGTCCA
Pig27Fw:Pig108Rv	AGGTACCGCATGAATAAGGACC	GCCTACGCTCCCTTTAAACCCA
Pig27Fw:Pig109Rv	AGGTACCGCATGAATAAGGACC	TCAGACTTACGTCCATTGACCA
Pig27Fw:Pig110Rv	AGGTACCGCATGAATAAGGACC	ATCTAAGCATTTCACCGCTACA
Pig27Fw:Pig111Rv	AGGTACCGCATGAATAAGGACC	AGCCGGCCTACGCTCCCTTTAA
Pig27Fw:Pig112Rv	AGGTACCGCATGAATAAGGACC	CGGCATTTCACAACACGCTTAA
Pig27Fw:Pig113Rv	AGGTACCGCATGAATAAGGACC	CGGAGTTCTTCGTGATATCTAA
Pig27Fw:Pig114Rv	AGGTACCGCATGAATAAGGACC	ACGCTCCCTTTAAACCCAATAA
Pig27Fw:Pig115Rv	AGGTACCGCATGAATAAGGACC	CTTATTCATGCGGTACCTGCAA
Pig27Fw:Pig116Rv	AGGTACCGCATGAATAAGGACC	CTACGGTAAGCTGCCTTCGCAA
Pig27Fw:Pig117Rv	AGGTACCGCATGAATAAGGACC	CCTACGCTCCCTTTAAACCCAA
Pig27Fw:Pig118Rv	AGGTACCGCATGAATAAGGACC	CAGACTTACGTCCATTGACCAA
Pig27Fw:Pig119Rv	AGGTACCGCATGAATAAGGACC	GCCGGCCTACGCTCCCTTTAAA
Pig27Fw:Pig120Rv	AGGTACCGCATGAATAAGGACC	GGCATTTCACAACACGCTTAAA
Pig27Fw:Pig121Rv	AGGTACCGCATGAATAAGGACC	TTATTCATGCGGTACCTGCAAA
Pig28Fw:Pig1Rv	AGGTAGGCGGAATTCGTGGTGT	CCTGCACGCTACTTGGCTGGTT
Pig28Fw:Pig2Rv	AGGTAGGCGGAATTCGTGGTGT	AGCTGCCTTCGCAATCGGAGTT
Pig28Fw:Pig3Rv	AGGTAGGCGGAATTCGTGGTGT	TGCCTTCGCAATCGGAGTTCTT
Pig28Fw:Pig4Rv	AGGTAGGCGGAATTCGTGGTGT	CGCGGCATTTCACAACACGCTT
Pig28Fw:Pig5Rv	AGGTAGGCGGAATTCGTGGTGT	CGATACCCGCACTTTCGAGCTT
Pig28Fw:Pig6Rv	AGGTAGGCGGAATTCGTGGTGT	GGCACGGAATTAGCCGGTCCTT
Pig28Fw:Pig7Rv	AGGTAGGCGGAATTCGTGGTGT	TAACGCTACGGTAAGCTGCCTT
Pig28Fw:Pig8Rv	AGGTAGGCGGAATTCGTGGTGT	GCCGTCATCCTGCACGCTACTT
Pig28Fw:Pig9Rv	AGGTAGGCGGAATTCGTGGTGT	ACGGAATTAGCCGGTCCTTATT
Pig28Fw:Pig10Rv	AGGTAGGCGGAATTCGTGGTGT	CTGGTTCAGACTTACGTCCATT
Pig28Fw:Pig11Rv	AGGTAGGCGGAATTCGTGGTGT	TCCTGCACGCTACTTGGCTGGT
Pig28Fw:Pig12Rv	AGGTAGGCGGAATTCGTGGTGT	TGCTGGCACGGAATTAGCCGGT
Pig28Fw:Pig13Rv	AGGTAGGCGGAATTCGTGGTGT	CCGCACTTTCGAGCTTCAGCGT
Pig28Fw:Pig14Rv	AGGTAGGCGGAATTCGTGGTGT	AGTTTACAACCCATAGGGCCGT
Pig28Fw:Pig15Rv	AGGTAGGCGGAATTCGTGGTGT	CTTGGCTGGTTCAGACTTACGT
Pig28Fw:Pig16Rv	AGGTAGGCGGAATTCGTGGTGT	AAGCTGCCTTCGCAATCGGAGT
Pig28Fw:Pig17Rv	AGGTAGGCGGAATTCGTGGTGT	CTGCCTTCGCAATCGGAGTTCT
Pig28Fw:Pig18Rv	AGGTAGGCGGAATTCGTGGTGT	ATCGGAGTTCTTCGTGATATCT
Pig28Fw:Pig19Rv	AGGTAGGCGGAATTCGTGGTGT	CTTCCGTATTACCGCGGCTGCT
Pig28Fw:Pig20Rv	AGGTAGGCGGAATTCGTGGTGT	TCATCCTGCACGCTACTTGGCT
Pig28Fw:Pig21Rv	AGGTAGGCGGAATTCGTGGTGT	GACCTTCCGTATTACCGCGGCT
Pig28Fw:Pig22Rv	AGGTAGGCGGAATTCGTGGTGT	GATATCTAAGCATTTCACCGCT
Pig28Fw:Pig23Rv	AGGTAGGCGGAATTCGTGGTGT	CCGCGGCATTTCACAACACGCT
Pig28Fw:Pig24Rv	AGGTAGGCGGAATTCGTGGTGT	TGGCACGGAATTAGCCGGTCCT
Pig28Fw:Pig25Rv	AGGTAGGCGGAATTCGTGGTGT	CAACCCATAGGGCCGTCATCCT
Pig28Fw:Pig26Rv	AGGTAGGCGGAATTCGTGGTGT	CGCTACACCACGAATTCCGCCT
Pig28Fw:Pig27Rv	AGGTAGGCGGAATTCGTGGTGT	GGTCCTTATTCATGCGGTACCT
Pig28Fw:Pig28Rv	AGGTAGGCGGAATTCGTGGTGT	ACACCACGAATTCCGCCTACCT
Pig28Fw:Pig29Rv	AGGTAGGCGGAATTCGTGGTGT	CGCTACTTGGCTGGTTCAGACT
Pig28Fw:Pig30Rv	AGGTAGGCGGAATTCGTGGTGT	CACGGAATTAGCCGGTCCTTAT
Pig28Fw:Pig31Rv	AGGTAGGCGGAATTCGTGGTGT	CAATCGGAGTTCTTCGTGATAT
Pig28Fw:Pig32Rv	AGGTAGGCGGAATTCGTGGTGT	CGCAATCGGAGTTCTTCGTGAT
Pig28Fw:Pig33Rv	AGGTAGGCGGAATTCGTGGTGT	TTACAACCCATAGGGCCGTCAT
Pig28Fw:Pig34Rv	AGGTAGGCGGAATTCGTGGTGT	GCTGGTTCAGACTTACGTCCAT
Pig28Fw:Pig35Rv	AGGTAGGCGGAATTCGTGGTGT	TACGGTAAGCTGCCTTCGCAAT
Pig28Fw:Pig36Rv	AGGTAGGCGGAATTCGTGGTGT	CTACGCTCCCTTTAAACCCAAT
Pig28Fw:Pig37Rv	AGGTAGGCGGAATTCGTGGTGT	CCGTCATCCTGCACGCTACTTG
Pig28Fw:Pig38Rv	AGGTAGGCGGAATTCGTGGTGT	TGGTTCAGACTTACGTCCATTG
Pig28Fw:Pig39Rv	AGGTAGGCGGAATTCGTGGTGT	TTCCGTATTACCGCGGCTGCTG
Pig28Fw:Pig40Rv	AGGTAGGCGGAATTCGTGGTGT	CATCCTGCACGCTACTTGGCTG
Pig28Fw:Pig41Rv	AGGTAGGCGGAATTCGTGGTGT	ACCTTCCGTATTACCGCGGCTG
Pig28Fw:Pig42Rv	AGGTAGGCGGAATTCGTGGTGT	AACCCATAGGGCCGTCATCCTG
Pig28Fw:Pig43Rv	AGGTAGGCGGAATTCGTGGTGT	GTCCTTATTCATGCGGTACCTG
Pig28Fw:Pig44Rv	AGGTAGGCGGAATTCGTGGTGT	AATTAGCCGGTCCTTATTCATG
Pig28Fw:Pig45Rv	AGGTAGGCGGAATTCGTGGTGT	CGTCATCCTGCACGCTACTTGG
Pig28Fw:Pig46Rv	AGGTAGGCGGAATTCGTGGTGT	ATCCTGCACGCTACTTGGCTGG
Pig28Fw:Pig47Rv	AGGTAGGCGGAATTCGTGGTGT	AAGCAGTTTACAACCCATAGGG
Pig28Fw:Pig48Rv	AGGTAGGCGGAATTCGTGGTGT	GGTAAGCTGCCTTCGCAATCGG
Pig28Fw:Pig49Rv	AGGTAGGCGGAATTCGTGGTGT	TAGCCGGTCCTTATTCATGCGG
Pig28Fw:Pig50Rv	AGGTAGGCGGAATTCGTGGTGT	AAAGCAGTTTACAACCCATAGG
Pig28Fw:Pig51Rv	AGGTAGGCGGAATTCGTGGTGT	ACGCTACGGTAAGCTGCCTTCG
Pig28Fw:Pig52Rv	AGGTAGGCGGAATTCGTGGTGT	CGGTAAGCTGCCTTCGCAATCG
Pig28Fw:Pig53Rv	AGGTAGGCGGAATTCGTGGTGT	TTAGCCGGTCCTTATTCATGCG
Pig28Fw:Pig54Rv	AGGTAGGCGGAATTCGTGGTGT	CAGTTTACAACCCATAGGGCCG
Pig28Fw:Pig55Rv	AGGTAGGCGGAATTCGTGGTGT	TAAGCTGCCTTCGCAATCGGAG
Pig28Fw:Pig56Rv	AGGTAGGCGGAATTCGTGGTGT	GCACGCTACTTGGCTGGTTCAG
Pig28Fw:Pig57Rv	AGGTAGGCGGAATTCGTGGTGT	TACCCGCACTTTCGAGCTTCAG
Pig28Fw:Pig58Rv	AGGTAGGCGGAATTCGTGGTGT	GGAGTTCTTCGTGATATCTAAG
Pig28Fw:Pig59Rv	AGGTAGGCGGAATTCGTGGTGT	CTGCACGCTACTTGGCTGGTTC
Pig28Fw:Pig60Rv	AGGTAGGCGGAATTCGTGGTGT	GCTGCCTTCGCAATCGGAGTTC
Pig28Fw:Pig61Rv	AGGTAGGCGGAATTCGTGGTGT	GATACCCGCACTTTCGAGCTTC
Pig28Fw:Pig62Rv	AGGTAGGCGGAATTCGTGGTGT	AACGCTACGGTAAGCTGCCTTC
Pig28Fw:Pig63Rv	AGGTAGGCGGAATTCGTGGTGT	CGCACTTTCGAGCTTCAGCGTC
Pig28Fw:Pig64Rv	AGGTAGGCGGAATTCGTGGTGT	GTTTACAACCCATAGGGCCGTC
Pig28Fw:Pig65Rv	AGGTAGGCGGAATTCGTGGTGT	TTGGCTGGTTCAGACTTACGTC
Pig28Fw:Pig66Rv	AGGTAGGCGGAATTCGTGGTGT	CACCACGAATTCCGCCTACCTC
Pig28Fw:Pig67Rv	AGGTAGGCGGAATTCGTGGTGT	AATCGGAGTTCTTCGTGATATC
Pig28Fw:Pig68Rv	AGGTAGGCGGAATTCGTGGTGT	TACAACCCATAGGGCCGTCATC
Pig28Fw:Pig69Rv	AGGTAGGCGGAATTCGTGGTGT	ACGGTAAGCTGCCTTCGCAATC
Pig28Fw:Pig70Rv	AGGTAGGCGGAATTCGTGGTGT	TCCTTATTCATGCGGTACCTGC
Pig28Fw:Pig71Rv	AGGTAGGCGGAATTCGTGGTGT	ATTAGCCGGTCCTTATTCATGC
Pig28Fw:Pig72Rv	AGGTAGGCGGAATTCGTGGTGT	GTCATCCTGCACGCTACTTGGC
Pig28Fw:Pig73Rv	AGGTAGGCGGAATTCGTGGTGT	AGCAGTTTACAACCCATAGGGC
Pig28Fw:Pig74Rv	AGGTAGGCGGAATTCGTGGTGT	TGATATCTAAGCATTTCACCGC
Pig28Fw:Pig75Rv	AGGTAGGCGGAATTCGTGGTGT	ACCCGCACTTTCGAGCTTCAGC
Pig28Fw:Pig76Rv	AGGTAGGCGGAATTCGTGGTGT	GAGTTCTTCGTGATATCTAAGC
Pig28Fw:Pig77Rv	AGGTAGGCGGAATTCGTGGTGT	TGGCTGGTTCAGACTTACGTCC
Pig28Fw:Pig78Rv	AGGTAGGCGGAATTCGTGGTGT	ACCACGAATTCCGCCTACCTCC
Pig28Fw:Pig79Rv	AGGTAGGCGGAATTCGTGGTGT	ACAACCCATAGGGCCGTCATCC
Pig28Fw:Pig80Rv	AGGTAGGCGGAATTCGTGGTGT	GCAGTTTACAACCCATAGGGCC
Pig28Fw:Pig81Rv	AGGTAGGCGGAATTCGTGGTGT	GGCCTACGCTCCCTTTAAACCC
Pig28Fw:Pig82Rv	AGGTAGGCGGAATTCGTGGTGT	TACACCACGAATTCCGCCTACC
Pig28Fw:Pig83Rv	AGGTAGGCGGAATTCGTGGTGT	TTCAGACTTACGTCCATTGACC
Pig28Fw:Pig84Rv	AGGTAGGCGGAATTCGTGGTGT	CGGCCTACGCTCCCTTTAAACC
Pig28Fw:Pig85Rv	AGGTAGGCGGAATTCGTGGTGT	TATCTAAGCATTTCACCGCTAC
Pig28Fw:Pig86Rv	AGGTAGGCGGAATTCGTGGTGT	GTTCAGACTTACGTCCATTGAC
Pig28Fw:Pig87Rv	AGGTAGGCGGAATTCGTGGTGT	ACGCTACTTGGCTGGTTCAGAC
Pig28Fw:Pig88Rv	AGGTAGGCGGAATTCGTGGTGT	TCTAAGCATTTCACCGCTACAC
Pig28Fw:Pig89Rv	AGGTAGGCGGAATTCGTGGTGT	CCGGCCTACGCTCCCTTTAAAC
Pig28Fw:Pig90Rv	AGGTAGGCGGAATTCGTGGTGT	AAGCCGGCCTACGCTCCCTTTA
Pig28Fw:Pig91Rv	AGGTAGGCGGAATTCGTGGTGT	GCGGCATTTCACAACACGCTTA
Pig28Fw:Pig92Rv	AGGTAGGCGGAATTCGTGGTGT	GCACGGAATTAGCCGGTCCTTA
