Pig5Fw:Pig1Rv	AAGCGTGTTGTGAAATGCCGCG	CCTGCACGCTACTTGGCTGGTT
Pig5Fw:Pig2Rv	AAGCGTGTTGTGAAATGCCGCG	AGCTGCCTTCGCAATCGGAGTT
Pig5Fw:Pig3Rv	AAGCGTGTTGTGAAATGCCGCG	TGCCTTCGCAATCGGAGTTCTT
Pig5Fw:Pig4Rv	AAGCGTGTTGTGAAATGCCGCG	GGCACGGAGTTAGCCGATGCTT
Pig5Fw:Pig5Rv	AAGCGTGTTGTGAAATGCCGCG	CGCGGCATTTCACAACACGCTT
Pig5Fw:Pig6Rv	AAGCGTGTTGTGAAATGCCGCG	CCAGTAAATCCGGACAACGCTT
Pig5Fw:Pig7Rv	AAGCGTGTTGTGAAATGCCGCG	CGATACCCGCACTTTCGAGCTT
Pig5Fw:Pig8Rv	AAGCGTGTTGTGAAATGCCGCG	GGCACGGAATTAGCCGGTCCTT
Pig5Fw:Pig9Rv	AAGCGTGTTGTGAAATGCCGCG	TAACGCTACGGTAAGCTGCCTT
Pig5Fw:Pig10Rv	AAGCGTGTTGTGAAATGCCGCG	GCCGTCATCCTGCACGCTACTT
Pig5Fw:Pig11Rv	AAGCGTGTTGTGAAATGCCGCG	ACGGAATTAGCCGGTCCTTATT
Pig5Fw:Pig12Rv	AAGCGTGTTGTGAAATGCCGCG	TAACGCTCGCATCCTCCGTATT
Pig5Fw:Pig13Rv	AAGCGTGTTGTGAAATGCCGCG	CAACGCTTGCCACCTACGTATT
Pig5Fw:Pig14Rv	AAGCGTGTTGTGAAATGCCGCG	CTGGTTCAGACTTCCGTCCATT
Pig5Fw:Pig15Rv	AAGCGTGTTGTGAAATGCCGCG	CTGGTTCAGACTTACGTCCATT
Pig5Fw:Pig16Rv	AAGCGTGTTGTGAAATGCCGCG	TTTCACCGCTACACTAGGAATT
Pig5Fw:Pig17Rv	AAGCGTGTTGTGAAATGCCGCG	TCCTGCACGCTACTTGGCTGGT
Pig5Fw:Pig18Rv	AAGCGTGTTGTGAAATGCCGCG	TGCTGGCACGGAATTAGCCGGT
Pig5Fw:Pig19Rv	AAGCGTGTTGTGAAATGCCGCG	CCGCACTTTCGAGCTTCAGCGT
Pig5Fw:Pig20Rv	AAGCGTGTTGTGAAATGCCGCG	CTTGGCTGGTTCAGACTTCCGT
Pig5Fw:Pig21Rv	AAGCGTGTTGTGAAATGCCGCG	AGTTTACAACCCATAGGGCCGT
Pig5Fw:Pig22Rv	AAGCGTGTTGTGAAATGCCGCG	CTGCTGGCACGTAGTTAGCCGT
Pig5Fw:Pig23Rv	AAGCGTGTTGTGAAATGCCGCG	CTTGGCTGGTTCAGACTTACGT
Pig5Fw:Pig24Rv	AAGCGTGTTGTGAAATGCCGCG	GGACAACGCTTGCCACCTACGT
Pig5Fw:Pig25Rv	AAGCGTGTTGTGAAATGCCGCG	AAGCTGCCTTCGCAATCGGAGT
Pig5Fw:Pig26Rv	AAGCGTGTTGTGAAATGCCGCG	CTGCCTTCGCAATCGGAGTTCT
Pig5Fw:Pig27Rv	AAGCGTGTTGTGAAATGCCGCG	ATCGGAGTTCTTCGTGATATCT
Pig5Fw:Pig28Rv	AAGCGTGTTGTGAAATGCCGCG	ACTGGTGTTCCTCCTAATATCT
Pig5Fw:Pig29Rv	AAGCGTGTTGTGAAATGCCGCG	CTTCCGTATTACCGCGGCTGCT
Pig5Fw:Pig30Rv	AAGCGTGTTGTGAAATGCCGCG	CCTACGTATTACCGCGGCTGCT
Pig5Fw:Pig31Rv	AAGCGTGTTGTGAAATGCCGCG	TGGCACGGAGTTAGCCGATGCT
Pig5Fw:Pig32Rv	AAGCGTGTTGTGAAATGCCGCG	TCATCCTGCACGCTACTTGGCT
Pig5Fw:Pig33Rv	AAGCGTGTTGTGAAATGCCGCG	GACCTTCCGTATTACCGCGGCT
Pig5Fw:Pig34Rv	AAGCGTGTTGTGAAATGCCGCG	CATCCTCCGTATTACCGCGGCT
Pig5Fw:Pig35Rv	AAGCGTGTTGTGAAATGCCGCG	CCACCTACGTATTACCGCGGCT
Pig5Fw:Pig36Rv	AAGCGTGTTGTGAAATGCCGCG	AATATCTACGCATTTCACCGCT
Pig5Fw:Pig37Rv	AAGCGTGTTGTGAAATGCCGCG	GATATCTAAGCATTTCACCGCT
Pig5Fw:Pig38Rv	AAGCGTGTTGTGAAATGCCGCG	CATATCTAAGCATTTCACCGCT
Pig5Fw:Pig39Rv	AAGCGTGTTGTGAAATGCCGCG	CCGCGGCATTTCACAACACGCT
Pig5Fw:Pig40Rv	AAGCGTGTTGTGAAATGCCGCG	CCCAGTAAATCCGGACAACGCT
Pig5Fw:Pig41Rv	AAGCGTGTTGTGAAATGCCGCG	TGGCACGGAATTAGCCGGTCCT
Pig5Fw:Pig42Rv	AAGCGTGTTGTGAAATGCCGCG	CTTCGCCACTGGTGTTCCTCCT
Pig5Fw:Pig43Rv	AAGCGTGTTGTGAAATGCCGCG	CAACCCATAGGGCCGTCATCCT
Pig5Fw:Pig44Rv	AAGCGTGTTGTGAAATGCCGCG	CGCTACACCACGAATTCCGCCT
Pig5Fw:Pig45Rv	AAGCGTGTTGTGAAATGCCGCG	GGTCCTTATTCATGCGGTACCT
Pig5Fw:Pig46Rv	AAGCGTGTTGTGAAATGCCGCG	ACACCACGAATTCCGCCTACCT
Pig5Fw:Pig47Rv	AAGCGTGTTGTGAAATGCCGCG	CGCTACTTGGCTGGTTCAGACT
Pig5Fw:Pig48Rv	AAGCGTGTTGTGAAATGCCGCG	CACGGAATTAGCCGGTCCTTAT
Pig5Fw:Pig49Rv	AAGCGTGTTGTGAAATGCCGCG	ATAACGCTCGCATCCTCCGTAT
Pig5Fw:Pig50Rv	AAGCGTGTTGTGAAATGCCGCG	ACAACGCTTGCCACCTACGTAT
Pig5Fw:Pig51Rv	AAGCGTGTTGTGAAATGCCGCG	CAATCGGAGTTCTTCGTGATAT
Pig5Fw:Pig52Rv	AAGCGTGTTGTGAAATGCCGCG	CCACTGGTGTTCCTCCTAATAT
Pig5Fw:Pig53Rv	AAGCGTGTTGTGAAATGCCGCG	CGCAATCGGAGTTCTTCGTGAT
Pig5Fw:Pig54Rv	AAGCGTGTTGTGAAATGCCGCG	TGCTGGCACGGAGTTAGCCGAT
Pig5Fw:Pig55Rv	AAGCGTGTTGTGAAATGCCGCG	TTACAACCCATAGGGCCGTCAT
Pig5Fw:Pig56Rv	AAGCGTGTTGTGAAATGCCGCG	GTTCCTCCTAATATCTACGCAT
Pig5Fw:Pig57Rv	AAGCGTGTTGTGAAATGCCGCG	GCTGGTTCAGACTTCCGTCCAT
Pig5Fw:Pig58Rv	AAGCGTGTTGTGAAATGCCGCG	GCTGGTTCAGACTTACGTCCAT
Pig5Fw:Pig59Rv	AAGCGTGTTGTGAAATGCCGCG	CGCCACTGGTGTTCCTCCTAAT
Pig5Fw:Pig60Rv	AAGCGTGTTGTGAAATGCCGCG	ATTTCACCGCTACACTAGGAAT
Pig5Fw:Pig61Rv	AAGCGTGTTGTGAAATGCCGCG	TACGGTAAGCTGCCTTCGCAAT
Pig5Fw:Pig62Rv	AAGCGTGTTGTGAAATGCCGCG	CTACGCTCCCTTTAAACCCAAT
Pig5Fw:Pig63Rv	AAGCGTGTTGTGAAATGCCGCG	CAGTAAATCCGGACAACGCTTG
Pig5Fw:Pig64Rv	AAGCGTGTTGTGAAATGCCGCG	CCGTCATCCTGCACGCTACTTG
Pig5Fw:Pig65Rv	AAGCGTGTTGTGAAATGCCGCG	TGGTTCAGACTTCCGTCCATTG
Pig5Fw:Pig66Rv	AAGCGTGTTGTGAAATGCCGCG	TGGTTCAGACTTACGTCCATTG
Pig5Fw:Pig67Rv	AAGCGTGTTGTGAAATGCCGCG	TGCCTTCGCAATCGGAGTTCTG
Pig5Fw:Pig68Rv	AAGCGTGTTGTGAAATGCCGCG	TTCCGTATTACCGCGGCTGCTG
Pig5Fw:Pig69Rv	AAGCGTGTTGTGAAATGCCGCG	CTACGTATTACCGCGGCTGCTG
Pig5Fw:Pig70Rv	AAGCGTGTTGTGAAATGCCGCG	CATCCTGCACGCTACTTGGCTG
Pig5Fw:Pig71Rv	AAGCGTGTTGTGAAATGCCGCG	ACCTTCCGTATTACCGCGGCTG
Pig5Fw:Pig72Rv	AAGCGTGTTGTGAAATGCCGCG	ATCCTCCGTATTACCGCGGCTG
Pig5Fw:Pig73Rv	AAGCGTGTTGTGAAATGCCGCG	CACCTACGTATTACCGCGGCTG
Pig5Fw:Pig74Rv	AAGCGTGTTGTGAAATGCCGCG	AACCCATAGGGCCGTCATCCTG
Pig5Fw:Pig75Rv	AAGCGTGTTGTGAAATGCCGCG	GTCCTTATTCATGCGGTACCTG
Pig5Fw:Pig76Rv	AAGCGTGTTGTGAAATGCCGCG	AATTAGCCGGTCCTTATTCATG
Pig5Fw:Pig77Rv	AAGCGTGTTGTGAAATGCCGCG	CGTCATCCTGCACGCTACTTGG
Pig5Fw:Pig78Rv	AAGCGTGTTGTGAAATGCCGCG	TACGTATTACCGCGGCTGCTGG
Pig5Fw:Pig79Rv	AAGCGTGTTGTGAAATGCCGCG	ATCCTGCACGCTACTTGGCTGG
Pig5Fw:Pig80Rv	AAGCGTGTTGTGAAATGCCGCG	AAGCAGTTTACAACCCATAGGG
Pig5Fw:Pig81Rv	AAGCGTGTTGTGAAATGCCGCG	GGTAAGCTGCCTTCGCAATCGG
Pig5Fw:Pig82Rv	AAGCGTGTTGTGAAATGCCGCG	TAGCCGGTCCTTATTCATGCGG
Pig5Fw:Pig83Rv	AAGCGTGTTGTGAAATGCCGCG	TGCCACCTACGTATTACCGCGG
Pig5Fw:Pig84Rv	AAGCGTGTTGTGAAATGCCGCG	CGCATTTCACCGCTACACTAGG
Pig5Fw:Pig85Rv	AAGCGTGTTGTGAAATGCCGCG	AAAGCAGTTTACAACCCATAGG
Pig5Fw:Pig86Rv	AAGCGTGTTGTGAAATGCCGCG	ACGCTACGGTAAGCTGCCTTCG
Pig5Fw:Pig87Rv	AAGCGTGTTGTGAAATGCCGCG	CGGTAAGCTGCCTTCGCAATCG
Pig5Fw:Pig88Rv	AAGCGTGTTGTGAAATGCCGCG	TTAGCCGGTCCTTATTCATGCG
Pig5Fw:Pig89Rv	AAGCGTGTTGTGAAATGCCGCG	TCGCATCCTCCGTATTACCGCG
Pig5Fw:Pig90Rv	AAGCGTGTTGTGAAATGCCGCG	TTGCCACCTACGTATTACCGCG
Pig5Fw:Pig91Rv	AAGCGTGTTGTGAAATGCCGCG	TCGCCACCTACGTATTACCGCG
Pig5Fw:Pig92Rv	AAGCGTGTTGTGAAATGCCGCG	CAGTTTACAACCCATAGGGCCG
Pig5Fw:Pig93Rv	AAGCGTGTTGTGAAATGCCGCG	GCTCGCATCCTCCGTATTACCG
Pig5Fw:Pig94Rv	AAGCGTGTTGTGAAATGCCGCG	GCTTGCCACCTACGTATTACCG
Pig5Fw:Pig95Rv	AAGCGTGTTGTGAAATGCCGCG	GCTCGCCACCTACGTATTACCG
Pig5Fw:Pig96Rv	AAGCGTGTTGTGAAATGCCGCG	CTAATATCTACGCATTTCACCG
Pig5Fw:Pig97Rv	AAGCGTGTTGTGAAATGCCGCG	GGTGTTCCTCCTAATATCTACG
Pig5Fw:Pig98Rv	AAGCGTGTTGTGAAATGCCGCG	CACCCAGTAAATCCGGACAACG
Pig5Fw:Pig99Rv	AAGCGTGTTGTGAAATGCCGCG	ACGCATTTCACCGCTACACTAG
Pig5Fw:Pig100Rv	AAGCGTGTTGTGAAATGCCGCG	TAAGCTGCCTTCGCAATCGGAG
Pig5Fw:Pig101Rv	AAGCGTGTTGTGAAATGCCGCG	GCACGCTACTTGGCTGGTTCAG
Pig5Fw:Pig102Rv	AAGCGTGTTGTGAAATGCCGCG	TCACGCGACTTGGCTGGTTCAG
Pig5Fw:Pig103Rv	AAGCGTGTTGTGAAATGCCGCG	TACCCGCACTTTCGAGCTTCAG
Pig5Fw:Pig104Rv	AAGCGTGTTGTGAAATGCCGCG	GGAGTTCTTCGTGATATCTAAG
Pig5Fw:Pig105Rv	AAGCGTGTTGTGAAATGCCGCG	CCTCCTAATATCTACGCATTTC
Pig5Fw:Pig106Rv	AAGCGTGTTGTGAAATGCCGCG	CTGCACGCTACTTGGCTGGTTC
Pig5Fw:Pig107Rv	AAGCGTGTTGTGAAATGCCGCG	GCTGCCTTCGCAATCGGAGTTC
Pig5Fw:Pig108Rv	AAGCGTGTTGTGAAATGCCGCG	GATACCCGCACTTTCGAGCTTC
Pig5Fw:Pig109Rv	AAGCGTGTTGTGAAATGCCGCG	AACGCTACGGTAAGCTGCCTTC
Pig5Fw:Pig110Rv	AAGCGTGTTGTGAAATGCCGCG	TTCACCGCTACACTAGGAATTC
Pig5Fw:Pig111Rv	AAGCGTGTTGTGAAATGCCGCG	CGCACTTTCGAGCTTCAGCGTC
Pig5Fw:Pig112Rv	AAGCGTGTTGTGAAATGCCGCG	TTGGCTGGTTCAGACTTCCGTC
Pig5Fw:Pig113Rv	AAGCGTGTTGTGAAATGCCGCG	GTTTACAACCCATAGGGCCGTC
Pig5Fw:Pig114Rv	AAGCGTGTTGTGAAATGCCGCG	TTGGCTGGTTCAGACTTACGTC
Pig5Fw:Pig115Rv	AAGCGTGTTGTGAAATGCCGCG	CACCACGAATTCCGCCTACCTC
Pig5Fw:Pig116Rv	AAGCGTGTTGTGAAATGCCGCG	AATCGGAGTTCTTCGTGATATC
Pig5Fw:Pig117Rv	AAGCGTGTTGTGAAATGCCGCG	CACTGGTGTTCCTCCTAATATC
Pig5Fw:Pig118Rv	AAGCGTGTTGTGAAATGCCGCG	TACAACCCATAGGGCCGTCATC
Pig5Fw:Pig119Rv	AAGCGTGTTGTGAAATGCCGCG	ACGGTAAGCTGCCTTCGCAATC
Pig5Fw:Pig120Rv	AAGCGTGTTGTGAAATGCCGCG	AGTAAATCCGGACAACGCTTGC
Pig5Fw:Pig121Rv	AAGCGTGTTGTGAAATGCCGCG	GCCTTCGCAATCGGAGTTCTGC
Pig5Fw:Pig122Rv	AAGCGTGTTGTGAAATGCCGCG	ACCTACGTATTACCGCGGCTGC
Pig5Fw:Pig123Rv	AAGCGTGTTGTGAAATGCCGCG	TCCTTATTCATGCGGTACCTGC
Pig5Fw:Pig124Rv	AAGCGTGTTGTGAAATGCCGCG	ATTAGCCGGTCCTTATTCATGC
Pig5Fw:Pig125Rv	AAGCGTGTTGTGAAATGCCGCG	GTCATCCTGCACGCTACTTGGC
Pig5Fw:Pig126Rv	AAGCGTGTTGTGAAATGCCGCG	AGCAGTTTACAACCCATAGGGC
Pig5Fw:Pig127Rv	AAGCGTGTTGTGAAATGCCGCG	CTCGCATCCTCCGTATTACCGC
Pig5Fw:Pig128Rv	AAGCGTGTTGTGAAATGCCGCG	CTTGCCACCTACGTATTACCGC
Pig5Fw:Pig129Rv	AAGCGTGTTGTGAAATGCCGCG	CTCGCCACCTACGTATTACCGC
Pig5Fw:Pig130Rv	AAGCGTGTTGTGAAATGCCGCG	TAATATCTACGCATTTCACCGC
Pig5Fw:Pig131Rv	AAGCGTGTTGTGAAATGCCGCG	TGATATCTAAGCATTTCACCGC
Pig5Fw:Pig132Rv	AAGCGTGTTGTGAAATGCCGCG	GTGTTCCTCCTAATATCTACGC
Pig5Fw:Pig133Rv	AAGCGTGTTGTGAAATGCCGCG	ACCCAGTAAATCCGGACAACGC
Pig5Fw:Pig134Rv	AAGCGTGTTGTGAAATGCCGCG	ACCCGCACTTTCGAGCTTCAGC
Pig5Fw:Pig135Rv	AAGCGTGTTGTGAAATGCCGCG	GAGTTCTTCGTGATATCTAAGC
Pig5Fw:Pig136Rv	AAGCGTGTTGTGAAATGCCGCG	TGGCTGGTTCAGACTTCCGTCC
Pig5Fw:Pig137Rv	AAGCGTGTTGTGAAATGCCGCG	TGGCTGGTTCAGACTTACGTCC
Pig5Fw:Pig138Rv	AAGCGTGTTGTGAAATGCCGCG	ACCACGAATTCCGCCTACCTCC
Pig5Fw:Pig139Rv	AAGCGTGTTGTGAAATGCCGCG	ACAACCCATAGGGCCGTCATCC
Pig5Fw:Pig140Rv	AAGCGTGTTGTGAAATGCCGCG	GCAGTTTACAACCCATAGGGCC
Pig5Fw:Pig141Rv	AAGCGTGTTGTGAAATGCCGCG	GGCCTACGCTCCCTTTAAACCC
Pig5Fw:Pig142Rv	AAGCGTGTTGTGAAATGCCGCG	CGCTCGCATCCTCCGTATTACC
Pig5Fw:Pig143Rv	AAGCGTGTTGTGAAATGCCGCG	CGCTTGCCACCTACGTATTACC
Pig5Fw:Pig144Rv	AAGCGTGTTGTGAAATGCCGCG	CGCTCGCCACCTACGTATTACC
Pig5Fw:Pig145Rv	AAGCGTGTTGTGAAATGCCGCG	TACACCACGAATTCCGCCTACC
Pig5Fw:Pig146Rv	AAGCGTGTTGTGAAATGCCGCG	TTCAGACTTCCGTCCATTGACC
Pig5Fw:Pig147Rv	AAGCGTGTTGTGAAATGCCGCG	TTCAGACTTACGTCCATTGACC
Pig5Fw:Pig148Rv	AAGCGTGTTGTGAAATGCCGCG	CCTAATATCTACGCATTTCACC
Pig5Fw:Pig149Rv	AAGCGTGTTGTGAAATGCCGCG	CGGCCTACGCTCCCTTTAAACC
Pig5Fw:Pig150Rv	AAGCGTGTTGTGAAATGCCGCG	ACGCTCGCATCCTCCGTATTAC
Pig5Fw:Pig151Rv	AAGCGTGTTGTGAAATGCCGCG	ACGCTTGCCACCTACGTATTAC
Pig5Fw:Pig152Rv	AAGCGTGTTGTGAAATGCCGCG	ACGCTCGCCACCTACGTATTAC
Pig5Fw:Pig153Rv	AAGCGTGTTGTGAAATGCCGCG	TGGTGTTCCTCCTAATATCTAC
Pig5Fw:Pig154Rv	AAGCGTGTTGTGAAATGCCGCG	TATCTATGCATTTCACCGCTAC
Pig5Fw:Pig155Rv	AAGCGTGTTGTGAAATGCCGCG	TATCTAAGCATTTCACCGCTAC
Pig5Fw:Pig156Rv	AAGCGTGTTGTGAAATGCCGCG	GTTCAGACTTCCGTCCATTGAC
Pig5Fw:Pig157Rv	AAGCGTGTTGTGAAATGCCGCG	GTTCAGACTTACGTCCATTGAC
Pig5Fw:Pig158Rv	AAGCGTGTTGTGAAATGCCGCG	ACGCTACTTGGCTGGTTCAGAC
Pig5Fw:Pig159Rv	AAGCGTGTTGTGAAATGCCGCG	TCTATGCATTTCACCGCTACAC
Pig5Fw:Pig160Rv	AAGCGTGTTGTGAAATGCCGCG	TCTAAGCATTTCACCGCTACAC
Pig5Fw:Pig161Rv	AAGCGTGTTGTGAAATGCCGCG	ACACCCAGTAAATCCGGACAAC
Pig5Fw:Pig162Rv	AAGCGTGTTGTGAAATGCCGCG	CCGGCCTACGCTCCCTTTAAAC
Pig5Fw:Pig163Rv	AAGCGTGTTGTGAAATGCCGCG	ACGGCCTACGCTCCCTTTAAAC
Pig5Fw:Pig164Rv	AAGCGTGTTGTGAAATGCCGCG	AAGCCGGCCTACGCTCCCTTTA
Pig5Fw:Pig165Rv	AAGCGTGTTGTGAAATGCCGCG	GCGGCATTTCACAACACGCTTA
Pig5Fw:Pig166Rv	AAGCGTGTTGTGAAATGCCGCG	GCACGGAATTAGCCGGTCCTTA
Pig5Fw:Pig167Rv	AAGCGTGTTGTGAAATGCCGCG	AACGCTCGCATCCTCCGTATTA
Pig5Fw:Pig168Rv	AAGCGTGTTGTGAAATGCCGCG	AACGCTTGCCACCTACGTATTA
Pig5Fw:Pig169Rv	AAGCGTGTTGTGAAATGCCGCG	AACGCTCGCCACCTACGTATTA
Pig5Fw:Pig170Rv	AAGCGTGTTGTGAAATGCCGCG	GATAACGCTCGCATCCTCCGTA
Pig5Fw:Pig171Rv	AAGCGTGTTGTGAAATGCCGCG	GACAACGCTTGCCACCTACGTA
Pig5Fw:Pig172Rv	AAGCGTGTTGTGAAATGCCGCG	TCGGAGTTCTTCGTGATATCTA
Pig5Fw:Pig173Rv	AAGCGTGTTGTGAAATGCCGCG	CTGGTGTTCCTCCTAATATCTA
Pig5Fw:Pig174Rv	AAGCGTGTTGTGAAATGCCGCG	ATATCTACGCATTTCACCGCTA
Pig5Fw:Pig175Rv	AAGCGTGTTGTGAAATGCCGCG	TTCGCCACTGGTGTTCCTCCTA
Pig5Fw:Pig176Rv	AAGCGTGTTGTGAAATGCCGCG	GCTACACCACGAATTCCGCCTA
Pig5Fw:Pig177Rv	AAGCGTGTTGTGAAATGCCGCG	TCCGGACAACGCTTGCCACCTA
Pig5Fw:Pig178Rv	AAGCGTGTTGTGAAATGCCGCG	TACGCATTTCACCGCTACACTA
Pig5Fw:Pig179Rv	AAGCGTGTTGTGAAATGCCGCG	GCAATCGGAGTTCTTCGTGATA
Pig5Fw:Pig180Rv	AAGCGTGTTGTGAAATGCCGCG	GCCACTGGTGTTCCTCCTAATA
Pig5Fw:Pig181Rv	AAGCGTGTTGTGAAATGCCGCG	TACGCTCCCTTTAAACCCAATA
Pig5Fw:Pig182Rv	AAGCGTGTTGTGAAATGCCGCG	GGTTCAGACTTCCGTCCATTGA
Pig5Fw:Pig183Rv	AAGCGTGTTGTGAAATGCCGCG	GGTTCAGACTTACGTCCATTGA
Pig5Fw:Pig184Rv	AAGCGTGTTGTGAAATGCCGCG	TCGCAATCGGAGTTCTTCGTGA
Pig5Fw:Pig185Rv	AAGCGTGTTGTGAAATGCCGCG	GTAAGCTGCCTTCGCAATCGGA
Pig5Fw:Pig186Rv	AAGCGTGTTGTGAAATGCCGCG	GCATTTCACCGCTACACTAGGA
Pig5Fw:Pig187Rv	AAGCGTGTTGTGAAATGCCGCG	CACGCTACTTGGCTGGTTCAGA
Pig5Fw:Pig188Rv	AAGCGTGTTGTGAAATGCCGCG	TGCACGCTACTTGGCTGGTTCA
Pig5Fw:Pig189Rv	AAGCGTGTTGTGAAATGCCGCG	ATACCCGCACTTTCGAGCTTCA
Pig5Fw:Pig190Rv	AAGCGTGTTGTGAAATGCCGCG	GCACTTTCGAGCTTCAGCGTCA
Pig5Fw:Pig191Rv	AAGCGTGTTGTGAAATGCCGCG	TTTACAACCCATAGGGCCGTCA
Pig5Fw:Pig192Rv	AAGCGTGTTGTGAAATGCCGCG	CCTTATTCATGCGGTACCTGCA
Pig5Fw:Pig193Rv	AAGCGTGTTGTGAAATGCCGCG	GCTACGGTAAGCTGCCTTCGCA
Pig5Fw:Pig194Rv	AAGCGTGTTGTGAAATGCCGCG	TGTTCCTCCTAATATCTACGCA
Pig5Fw:Pig195Rv	AAGCGTGTTGTGAAATGCCGCG	GGCTGGTTCAGACTTCCGTCCA
Pig5Fw:Pig196Rv	AAGCGTGTTGTGAAATGCCGCG	GGCTGGTTCAGACTTACGTCCA
Pig5Fw:Pig197Rv	AAGCGTGTTGTGAAATGCCGCG	GCCTACGCTCCCTTTAAACCCA
Pig5Fw:Pig198Rv	AAGCGTGTTGTGAAATGCCGCG	TCAGACTTCCGTCCATTGACCA
Pig5Fw:Pig199Rv	AAGCGTGTTGTGAAATGCCGCG	TCAGACTTACGTCCATTGACCA
Pig5Fw:Pig200Rv	AAGCGTGTTGTGAAATGCCGCG	ATCTATGCATTTCACCGCTACA
Pig5Fw:Pig201Rv	AAGCGTGTTGTGAAATGCCGCG	ATCTAAGCATTTCACCGCTACA
Pig5Fw:Pig202Rv	AAGCGTGTTGTGAAATGCCGCG	AGCCGGCCTACGCTCCCTTTAA
Pig5Fw:Pig203Rv	AAGCGTGTTGTGAAATGCCGCG	CGGCATTTCACAACACGCTTAA
Pig5Fw:Pig204Rv	AAGCGTGTTGTGAAATGCCGCG	CGGAGTTCTTCGTGATATCTAA
Pig5Fw:Pig205Rv	AAGCGTGTTGTGAAATGCCGCG	TCGCCACTGGTGTTCCTCCTAA
Pig5Fw:Pig206Rv	AAGCGTGTTGTGAAATGCCGCG	ACGCTCCCTTTAAACCCAATAA
Pig5Fw:Pig207Rv	AAGCGTGTTGTGAAATGCCGCG	CATTTCACCGCTACACTAGGAA
Pig5Fw:Pig208Rv	AAGCGTGTTGTGAAATGCCGCG	CTTATTCATGCGGTACCTGCAA
Pig5Fw:Pig209Rv	AAGCGTGTTGTGAAATGCCGCG	CTACGGTAAGCTGCCTTCGCAA
Pig5Fw:Pig210Rv	AAGCGTGTTGTGAAATGCCGCG	CCTACGCTCCCTTTAAACCCAA
Pig5Fw:Pig211Rv	AAGCGTGTTGTGAAATGCCGCG	CAGACTTCCGTCCATTGACCAA
Pig5Fw:Pig212Rv	AAGCGTGTTGTGAAATGCCGCG	CAGACTTACGTCCATTGACCAA
Pig5Fw:Pig213Rv	AAGCGTGTTGTGAAATGCCGCG	TACACCCAGTAAATCCGGACAA
Pig5Fw:Pig214Rv	AAGCGTGTTGTGAAATGCCGCG	GCCGGCCTACGCTCCCTTTAAA
Pig5Fw:Pig215Rv	AAGCGTGTTGTGAAATGCCGCG	GGCATTTCACAACACGCTTAAA
Pig5Fw:Pig216Rv	AAGCGTGTTGTGAAATGCCGCG	TTATTCATGCGGTACCTGCAAA
Pig5Fw:Pig217Rv	AAGCGTGTTGTGAAATGCCGCG	GCACGGAGTTAGCCGATGCTTT
Pig5Fw:Pig218Rv	AAGCGTGTTGTGAAATGCCGCG	CCTTCACGCGACTTGGCTGGTT
Pig5Fw:Pig219Rv	AAGCGTGTTGTGAAATGCCGCG	ACGGAGTTAGCCGATGCTTATT
Pig5Fw:Pig220Rv	AAGCGTGTTGTGAAATGCCGCG	CAACGCTCGCCACCTACGTATT
Pig5Fw:Pig221Rv	AAGCGTGTTGTGAAATGCCGCG	TTTCACCGCTACACAACGCATT
Pig5Fw:Pig222Rv	AAGCGTGTTGTGAAATGCCGCG	CTGGTTCAGGCTCTCGCCCATT
Pig5Fw:Pig223Rv	AAGCGTGTTGTGAAATGCCGCG	TTTCACCGCTACACGACGAATT
Pig5Fw:Pig224Rv	AAGCGTGTTGTGAAATGCCGCG	TCCTTCACGCGACTTGGCTGGT
Pig5Fw:Pig225Rv	AAGCGTGTTGTGAAATGCCGCG	ATCGGAGTTCTGCGTCATATCT
Pig5Fw:Pig226Rv	AAGCGTGTTGTGAAATGCCGCG	TCGTCCTGCACGCTACTTGGCT
Pig5Fw:Pig227Rv	AAGCGTGTTGTGAAATGCCGCG	CCCAGTAATTCCGGACAACGCT
Pig5Fw:Pig228Rv	AAGCGTGTTGTGAAATGCCGCG	ATCCGGACAACGCTTGCCACCT
Pig5Fw:Pig229Rv	AAGCGTGTTGTGAAATGCCGCG	CACGGAGTTAGCCGATGCTTAT
Pig5Fw:Pig230Rv	AAGCGTGTTGTGAAATGCCGCG	ACAACGCTCGCCACCTACGTAT
Pig5Fw:Pig231Rv	AAGCGTGTTGTGAAATGCCGCG	CGGAGTTCTGCGTCATATCTAT
Pig5Fw:Pig232Rv	AAGCGTGTTGTGAAATGCCGCG	CAATCGGAGTTCTGCGTCATAT
Pig5Fw:Pig233Rv	AAGCGTGTTGTGAAATGCCGCG	ATTTCACCGCTACACAACGCAT
Pig5Fw:Pig234Rv	AAGCGTGTTGTGAAATGCCGCG	ATTTCACCGCTACACGACGAAT
Pig5Fw:Pig235Rv	AAGCGTGTTGTGAAATGCCGCG	TGGTTCAGGCTCTCGCCCATTG
Pig5Fw:Pig236Rv	AAGCGTGTTGTGAAATGCCGCG	AAAGAGGTTTACAATCCGTAGG
Pig5Fw:Pig237Rv	AAGCGTGTTGTGAAATGCCGCG	CACGCTACTTGGCTGGTTCAGG
Pig5Fw:Pig238Rv	AAGCGTGTTGTGAAATGCCGCG	CACCGCTACACAACGCATTCCG
Pig5Fw:Pig239Rv	AAGCGTGTTGTGAAATGCCGCG	CCCTTTACGCCCAATAATTCCG
Pig5Fw:Pig240Rv	AAGCGTGTTGTGAAATGCCGCG	CACCGCTACACGACGAATTCCG
Pig5Fw:Pig241Rv	AAGCGTGTTGTGAAATGCCGCG	GTCATATCTAAGCATTTCACCG
Pig5Fw:Pig242Rv	AAGCGTGTTGTGAAATGCCGCG	AGCATTTCACCGCTACACGACG
Pig5Fw:Pig243Rv	AAGCGTGTTGTGAAATGCCGCG	CTAAGCATTTCACCGCTACACG
Pig5Fw:Pig244Rv	AAGCGTGTTGTGAAATGCCGCG	CACCCAGTAATTCCGGACAACG
Pig5Fw:Pig245Rv	AAGCGTGTTGTGAAATGCCGCG	TGCATTTCACCGCTACACAACG
Pig5Fw:Pig246Rv	AAGCGTGTTGTGAAATGCCGCG	CAAGCTGCCTTCGCAATCGGAG
Pig5Fw:Pig247Rv	AAGCGTGTTGTGAAATGCCGCG	CTTCACGCGACTTGGCTGGTTC
Pig5Fw:Pig248Rv	AAGCGTGTTGTGAAATGCCGCG	CGGAGTTAGCCGATGCTTATTC
Pig5Fw:Pig249Rv	AAGCGTGTTGTGAAATGCCGCG	TTCACCGCTACACAACGCATTC
Pig5Fw:Pig250Rv	AAGCGTGTTGTGAAATGCCGCG	TTCACCGCTACACGACGAATTC
Pig5Fw:Pig251Rv	AAGCGTGTTGTGAAATGCCGCG	AATCGGAGTTCTGCGTCATATC
Pig5Fw:Pig252Rv	AAGCGTGTTGTGAAATGCCGCG	ACGCTACTTGGCTGGTTCAGGC
Pig5Fw:Pig253Rv	AAGCGTGTTGTGAAATGCCGCG	TCATATCTAAGCATTTCACCGC
Pig5Fw:Pig254Rv	AAGCGTGTTGTGAAATGCCGCG	ACCCAGTAATTCCGGACAACGC
Pig5Fw:Pig255Rv	AAGCGTGTTGTGAAATGCCGCG	GCATTTCACCGCTACACAACGC
Pig5Fw:Pig256Rv	AAGCGTGTTGTGAAATGCCGCG	TCACCGCTACACAACGCATTCC
Pig5Fw:Pig257Rv	AAGCGTGTTGTGAAATGCCGCG	TCACCGCTACACGACGAATTCC
Pig5Fw:Pig258Rv	AAGCGTGTTGTGAAATGCCGCG	GTAAATCCGGACAACGCTTGCC
Pig5Fw:Pig259Rv	AAGCGTGTTGTGAAATGCCGCG	TTCAGGCTCTCGCCCATTGACC
Pig5Fw:Pig260Rv	AAGCGTGTTGTGAAATGCCGCG	GAGGTTTACAATCCGTAGGACC
Pig5Fw:Pig261Rv	AAGCGTGTTGTGAAATGCCGCG	CGTCATATCTAAGCATTTCACC
Pig5Fw:Pig262Rv	AAGCGTGTTGTGAAATGCCGCG	AATCCGGACAACGCTTGCCACC
Pig5Fw:Pig263Rv	AAGCGTGTTGTGAAATGCCGCG	CCGCCTACGCACCCTTTAAACC
Pig5Fw:Pig264Rv	AAGCGTGTTGTGAAATGCCGCG	GTTCAGGCTCTCGCCCATTGAC
Pig5Fw:Pig265Rv	AAGCGTGTTGTGAAATGCCGCG	AGAGGTTTACAATCCGTAGGAC
Pig5Fw:Pig266Rv	AAGCGTGTTGTGAAATGCCGCG	AAGCATTTCACCGCTACACGAC
Pig5Fw:Pig267Rv	AAGCGTGTTGTGAAATGCCGCG	AAATCCGGACAACGCTTGCCAC
Pig5Fw:Pig268Rv	AAGCGTGTTGTGAAATGCCGCG	AATTCCGGACAACGCTCGCCAC
Pig5Fw:Pig269Rv	AAGCGTGTTGTGAAATGCCGCG	ACACCCAGTAATTCCGGACAAC
Pig5Fw:Pig270Rv	AAGCGTGTTGTGAAATGCCGCG	ATGCATTTCACCGCTACACAAC
Pig5Fw:Pig271Rv	AAGCGTGTTGTGAAATGCCGCG	GCACGGAGTTAGCCGATGCTTA
Pig5Fw:Pig272Rv	AAGCGTGTTGTGAAATGCCGCG	GACAACGCTCGCCACCTACGTA
Pig5Fw:Pig273Rv	AAGCGTGTTGTGAAATGCCGCG	TCGGAGTTCTGCGTCATATCTA
Pig5Fw:Pig274Rv	AAGCGTGTTGTGAAATGCCGCG	GCAATCGGAGTTCTGCGTCATA
Pig5Fw:Pig275Rv	AAGCGTGTTGTGAAATGCCGCG	GGTTCAGGCTCTCGCCCATTGA
Pig5Fw:Pig276Rv	AAGCGTGTTGTGAAATGCCGCG	CTTTACGCCCAATAATTCCGGA
Pig5Fw:Pig277Rv	AAGCGTGTTGTGAAATGCCGCG	AAGAGGTTTACAATCCGTAGGA
Pig5Fw:Pig278Rv	AAGCGTGTTGTGAAATGCCGCG	GCATTTCACCGCTACACGACGA
Pig5Fw:Pig279Rv	AAGCGTGTTGTGAAATGCCGCG	TAAGCATTTCACCGCTACACGA
Pig5Fw:Pig280Rv	AAGCGTGTTGTGAAATGCCGCG	CTCACGCGACTTGGCTGGTTCA
Pig5Fw:Pig281Rv	AAGCGTGTTGTGAAATGCCGCG	CATTTCACCGCTACACAACGCA
Pig5Fw:Pig282Rv	AAGCGTGTTGTGAAATGCCGCG	TAAATCCGGACAACGCTTGCCA
Pig5Fw:Pig283Rv	AAGCGTGTTGTGAAATGCCGCG	TAATTCCGGACAACGCTCGCCA
Pig5Fw:Pig284Rv	AAGCGTGTTGTGAAATGCCGCG	TCAGGCTCTCGCCCATTGACCA
Pig5Fw:Pig285Rv	AAGCGTGTTGTGAAATGCCGCG	CTATGCATTTCACCGCTACACA
Pig5Fw:Pig286Rv	AAGCGTGTTGTGAAATGCCGCG	CATTTCACCGCTACACGACGAA
Pig5Fw:Pig287Rv	AAGCGTGTTGTGAAATGCCGCG	CAGGCTCTCGCCCATTGACCAA
Pig5Fw:Pig288Rv	AAGCGTGTTGTGAAATGCCGCG	TACACCCAGTAATTCCGGACAA
Pig5Fw:Pig289Rv	AAGCGTGTTGTGAAATGCCGCG	TATGCATTTCACCGCTACACAA
Pig7Fw:Pig1Rv	AAGCTCGAAAGTGCGGGTATCG	CCTGCACGCTACTTGGCTGGTT
Pig7Fw:Pig2Rv	AAGCTCGAAAGTGCGGGTATCG	AGCTGCCTTCGCAATCGGAGTT
Pig7Fw:Pig3Rv	AAGCTCGAAAGTGCGGGTATCG	TGCCTTCGCAATCGGAGTTCTT
Pig7Fw:Pig4Rv	AAGCTCGAAAGTGCGGGTATCG	GGCACGGAGTTAGCCGATGCTT
Pig7Fw:Pig5Rv	AAGCTCGAAAGTGCGGGTATCG	CGCGGCATTTCACAACACGCTT
Pig7Fw:Pig6Rv	AAGCTCGAAAGTGCGGGTATCG	CCAGTAAATCCGGACAACGCTT
Pig7Fw:Pig7Rv	AAGCTCGAAAGTGCGGGTATCG	CGATACCCGCACTTTCGAGCTT
Pig7Fw:Pig8Rv	AAGCTCGAAAGTGCGGGTATCG	GGCACGGAATTAGCCGGTCCTT
Pig7Fw:Pig9Rv	AAGCTCGAAAGTGCGGGTATCG	TAACGCTACGGTAAGCTGCCTT
Pig7Fw:Pig10Rv	AAGCTCGAAAGTGCGGGTATCG	GCCGTCATCCTGCACGCTACTT
Pig7Fw:Pig11Rv	AAGCTCGAAAGTGCGGGTATCG	ACGGAATTAGCCGGTCCTTATT
Pig7Fw:Pig12Rv	AAGCTCGAAAGTGCGGGTATCG	TAACGCTCGCATCCTCCGTATT
Pig7Fw:Pig13Rv	AAGCTCGAAAGTGCGGGTATCG	CAACGCTTGCCACCTACGTATT
Pig7Fw:Pig14Rv	AAGCTCGAAAGTGCGGGTATCG	CTGGTTCAGACTTCCGTCCATT
Pig7Fw:Pig15Rv	AAGCTCGAAAGTGCGGGTATCG	CTGGTTCAGACTTACGTCCATT
Pig7Fw:Pig16Rv	AAGCTCGAAAGTGCGGGTATCG	TTTCACCGCTACACTAGGAATT
Pig7Fw:Pig17Rv	AAGCTCGAAAGTGCGGGTATCG	TCCTGCACGCTACTTGGCTGGT
Pig7Fw:Pig18Rv	AAGCTCGAAAGTGCGGGTATCG	TGCTGGCACGGAATTAGCCGGT
Pig7Fw:Pig19Rv	AAGCTCGAAAGTGCGGGTATCG	CCGCACTTTCGAGCTTCAGCGT
Pig7Fw:Pig20Rv	AAGCTCGAAAGTGCGGGTATCG	CTTGGCTGGTTCAGACTTCCGT
Pig7Fw:Pig21Rv	AAGCTCGAAAGTGCGGGTATCG	AGTTTACAACCCATAGGGCCGT
Pig7Fw:Pig22Rv	AAGCTCGAAAGTGCGGGTATCG	CTGCTGGCACGTAGTTAGCCGT
Pig7Fw:Pig23Rv	AAGCTCGAAAGTGCGGGTATCG	CTTGGCTGGTTCAGACTTACGT
Pig7Fw:Pig24Rv	AAGCTCGAAAGTGCGGGTATCG	GGACAACGCTTGCCACCTACGT
Pig7Fw:Pig25Rv	AAGCTCGAAAGTGCGGGTATCG	AAGCTGCCTTCGCAATCGGAGT
Pig7Fw:Pig26Rv	AAGCTCGAAAGTGCGGGTATCG	CTGCCTTCGCAATCGGAGTTCT
Pig7Fw:Pig27Rv	AAGCTCGAAAGTGCGGGTATCG	ATCGGAGTTCTTCGTGATATCT
Pig7Fw:Pig28Rv	AAGCTCGAAAGTGCGGGTATCG	ACTGGTGTTCCTCCTAATATCT
Pig7Fw:Pig29Rv	AAGCTCGAAAGTGCGGGTATCG	CTTCCGTATTACCGCGGCTGCT
Pig7Fw:Pig30Rv	AAGCTCGAAAGTGCGGGTATCG	CCTACGTATTACCGCGGCTGCT
Pig7Fw:Pig31Rv	AAGCTCGAAAGTGCGGGTATCG	TGGCACGGAGTTAGCCGATGCT
Pig7Fw:Pig32Rv	AAGCTCGAAAGTGCGGGTATCG	TCATCCTGCACGCTACTTGGCT
Pig7Fw:Pig33Rv	AAGCTCGAAAGTGCGGGTATCG	GACCTTCCGTATTACCGCGGCT
Pig7Fw:Pig34Rv	AAGCTCGAAAGTGCGGGTATCG	CATCCTCCGTATTACCGCGGCT
Pig7Fw:Pig35Rv	AAGCTCGAAAGTGCGGGTATCG	CCACCTACGTATTACCGCGGCT
Pig7Fw:Pig36Rv	AAGCTCGAAAGTGCGGGTATCG	AATATCTACGCATTTCACCGCT
Pig7Fw:Pig37Rv	AAGCTCGAAAGTGCGGGTATCG	GATATCTAAGCATTTCACCGCT
Pig7Fw:Pig38Rv	AAGCTCGAAAGTGCGGGTATCG	CATATCTAAGCATTTCACCGCT
Pig7Fw:Pig39Rv	AAGCTCGAAAGTGCGGGTATCG	CCGCGGCATTTCACAACACGCT
Pig7Fw:Pig40Rv	AAGCTCGAAAGTGCGGGTATCG	CCCAGTAAATCCGGACAACGCT
Pig7Fw:Pig41Rv	AAGCTCGAAAGTGCGGGTATCG	TGGCACGGAATTAGCCGGTCCT
Pig7Fw:Pig42Rv	AAGCTCGAAAGTGCGGGTATCG	CTTCGCCACTGGTGTTCCTCCT
Pig7Fw:Pig43Rv	AAGCTCGAAAGTGCGGGTATCG	CAACCCATAGGGCCGTCATCCT
Pig7Fw:Pig44Rv	AAGCTCGAAAGTGCGGGTATCG	CGCTACACCACGAATTCCGCCT
Pig7Fw:Pig45Rv	AAGCTCGAAAGTGCGGGTATCG	GGTCCTTATTCATGCGGTACCT
Pig7Fw:Pig46Rv	AAGCTCGAAAGTGCGGGTATCG	ACACCACGAATTCCGCCTACCT
Pig7Fw:Pig47Rv	AAGCTCGAAAGTGCGGGTATCG	CGCTACTTGGCTGGTTCAGACT
Pig7Fw:Pig48Rv	AAGCTCGAAAGTGCGGGTATCG	CACGGAATTAGCCGGTCCTTAT
Pig7Fw:Pig49Rv	AAGCTCGAAAGTGCGGGTATCG	ATAACGCTCGCATCCTCCGTAT
Pig7Fw:Pig50Rv	AAGCTCGAAAGTGCGGGTATCG	ACAACGCTTGCCACCTACGTAT
Pig7Fw:Pig51Rv	AAGCTCGAAAGTGCGGGTATCG	CAATCGGAGTTCTTCGTGATAT
Pig7Fw:Pig52Rv	AAGCTCGAAAGTGCGGGTATCG	CCACTGGTGTTCCTCCTAATAT
Pig7Fw:Pig53Rv	AAGCTCGAAAGTGCGGGTATCG	CGCAATCGGAGTTCTTCGTGAT
Pig7Fw:Pig54Rv	AAGCTCGAAAGTGCGGGTATCG	TGCTGGCACGGAGTTAGCCGAT
Pig7Fw:Pig55Rv	AAGCTCGAAAGTGCGGGTATCG	TTACAACCCATAGGGCCGTCAT
Pig7Fw:Pig56Rv	AAGCTCGAAAGTGCGGGTATCG	GTTCCTCCTAATATCTACGCAT
Pig7Fw:Pig57Rv	AAGCTCGAAAGTGCGGGTATCG	GCTGGTTCAGACTTCCGTCCAT
Pig7Fw:Pig58Rv	AAGCTCGAAAGTGCGGGTATCG	GCTGGTTCAGACTTACGTCCAT
Pig7Fw:Pig59Rv	AAGCTCGAAAGTGCGGGTATCG	CGCCACTGGTGTTCCTCCTAAT
Pig7Fw:Pig60Rv	AAGCTCGAAAGTGCGGGTATCG	ATTTCACCGCTACACTAGGAAT
Pig7Fw:Pig61Rv	AAGCTCGAAAGTGCGGGTATCG	TACGGTAAGCTGCCTTCGCAAT
Pig7Fw:Pig62Rv	AAGCTCGAAAGTGCGGGTATCG	CTACGCTCCCTTTAAACCCAAT
Pig7Fw:Pig63Rv	AAGCTCGAAAGTGCGGGTATCG	CAGTAAATCCGGACAACGCTTG
Pig7Fw:Pig64Rv	AAGCTCGAAAGTGCGGGTATCG	CCGTCATCCTGCACGCTACTTG
Pig7Fw:Pig65Rv	AAGCTCGAAAGTGCGGGTATCG	TGGTTCAGACTTCCGTCCATTG
Pig7Fw:Pig66Rv	AAGCTCGAAAGTGCGGGTATCG	TGGTTCAGACTTACGTCCATTG
Pig7Fw:Pig67Rv	AAGCTCGAAAGTGCGGGTATCG	TGCCTTCGCAATCGGAGTTCTG
Pig7Fw:Pig68Rv	AAGCTCGAAAGTGCGGGTATCG	TTCCGTATTACCGCGGCTGCTG
Pig7Fw:Pig69Rv	AAGCTCGAAAGTGCGGGTATCG	CTACGTATTACCGCGGCTGCTG
Pig7Fw:Pig70Rv	AAGCTCGAAAGTGCGGGTATCG	CATCCTGCACGCTACTTGGCTG
Pig7Fw:Pig71Rv	AAGCTCGAAAGTGCGGGTATCG	ACCTTCCGTATTACCGCGGCTG
Pig7Fw:Pig72Rv	AAGCTCGAAAGTGCGGGTATCG	ATCCTCCGTATTACCGCGGCTG
Pig7Fw:Pig73Rv	AAGCTCGAAAGTGCGGGTATCG	CACCTACGTATTACCGCGGCTG
Pig7Fw:Pig74Rv	AAGCTCGAAAGTGCGGGTATCG	AACCCATAGGGCCGTCATCCTG
Pig7Fw:Pig75Rv	AAGCTCGAAAGTGCGGGTATCG	GTCCTTATTCATGCGGTACCTG
Pig7Fw:Pig76Rv	AAGCTCGAAAGTGCGGGTATCG	AATTAGCCGGTCCTTATTCATG
Pig7Fw:Pig77Rv	AAGCTCGAAAGTGCGGGTATCG	CGTCATCCTGCACGCTACTTGG
Pig7Fw:Pig78Rv	AAGCTCGAAAGTGCGGGTATCG	TACGTATTACCGCGGCTGCTGG
Pig7Fw:Pig79Rv	AAGCTCGAAAGTGCGGGTATCG	ATCCTGCACGCTACTTGGCTGG
Pig7Fw:Pig80Rv	AAGCTCGAAAGTGCGGGTATCG	AAGCAGTTTACAACCCATAGGG
Pig7Fw:Pig81Rv	AAGCTCGAAAGTGCGGGTATCG	GGTAAGCTGCCTTCGCAATCGG
Pig7Fw:Pig82Rv	AAGCTCGAAAGTGCGGGTATCG	TAGCCGGTCCTTATTCATGCGG
Pig7Fw:Pig83Rv	AAGCTCGAAAGTGCGGGTATCG	TGCCACCTACGTATTACCGCGG
Pig7Fw:Pig84Rv	AAGCTCGAAAGTGCGGGTATCG	CGCATTTCACCGCTACACTAGG
Pig7Fw:Pig85Rv	AAGCTCGAAAGTGCGGGTATCG	AAAGCAGTTTACAACCCATAGG
Pig7Fw:Pig86Rv	AAGCTCGAAAGTGCGGGTATCG	ACGCTACGGTAAGCTGCCTTCG
Pig7Fw:Pig87Rv	AAGCTCGAAAGTGCGGGTATCG	CGGTAAGCTGCCTTCGCAATCG
Pig7Fw:Pig88Rv	AAGCTCGAAAGTGCGGGTATCG	TTAGCCGGTCCTTATTCATGCG
Pig7Fw:Pig89Rv	AAGCTCGAAAGTGCGGGTATCG	TCGCATCCTCCGTATTACCGCG
Pig7Fw:Pig90Rv	AAGCTCGAAAGTGCGGGTATCG	TTGCCACCTACGTATTACCGCG
Pig7Fw:Pig91Rv	AAGCTCGAAAGTGCGGGTATCG	TCGCCACCTACGTATTACCGCG
Pig7Fw:Pig92Rv	AAGCTCGAAAGTGCGGGTATCG	CAGTTTACAACCCATAGGGCCG
Pig7Fw:Pig93Rv	AAGCTCGAAAGTGCGGGTATCG	GCTCGCATCCTCCGTATTACCG
Pig7Fw:Pig94Rv	AAGCTCGAAAGTGCGGGTATCG	GCTTGCCACCTACGTATTACCG
Pig7Fw:Pig95Rv	AAGCTCGAAAGTGCGGGTATCG	GCTCGCCACCTACGTATTACCG
Pig7Fw:Pig96Rv	AAGCTCGAAAGTGCGGGTATCG	CTAATATCTACGCATTTCACCG
Pig7Fw:Pig97Rv	AAGCTCGAAAGTGCGGGTATCG	GGTGTTCCTCCTAATATCTACG
Pig7Fw:Pig98Rv	AAGCTCGAAAGTGCGGGTATCG	CACCCAGTAAATCCGGACAACG
Pig7Fw:Pig99Rv	AAGCTCGAAAGTGCGGGTATCG	ACGCATTTCACCGCTACACTAG
Pig7Fw:Pig100Rv	AAGCTCGAAAGTGCGGGTATCG	TAAGCTGCCTTCGCAATCGGAG
Pig7Fw:Pig101Rv	AAGCTCGAAAGTGCGGGTATCG	GCACGCTACTTGGCTGGTTCAG
Pig7Fw:Pig102Rv	AAGCTCGAAAGTGCGGGTATCG	TCACGCGACTTGGCTGGTTCAG
Pig7Fw:Pig103Rv	AAGCTCGAAAGTGCGGGTATCG	TACCCGCACTTTCGAGCTTCAG
Pig7Fw:Pig104Rv	AAGCTCGAAAGTGCGGGTATCG	GGAGTTCTTCGTGATATCTAAG
Pig7Fw:Pig105Rv	AAGCTCGAAAGTGCGGGTATCG	CCTCCTAATATCTACGCATTTC
Pig7Fw:Pig106Rv	AAGCTCGAAAGTGCGGGTATCG	CTGCACGCTACTTGGCTGGTTC
Pig7Fw:Pig107Rv	AAGCTCGAAAGTGCGGGTATCG	GCTGCCTTCGCAATCGGAGTTC
Pig7Fw:Pig108Rv	AAGCTCGAAAGTGCGGGTATCG	GATACCCGCACTTTCGAGCTTC
Pig7Fw:Pig109Rv	AAGCTCGAAAGTGCGGGTATCG	AACGCTACGGTAAGCTGCCTTC
Pig7Fw:Pig110Rv	AAGCTCGAAAGTGCGGGTATCG	TTCACCGCTACACTAGGAATTC
Pig7Fw:Pig111Rv	AAGCTCGAAAGTGCGGGTATCG	CGCACTTTCGAGCTTCAGCGTC
Pig7Fw:Pig112Rv	AAGCTCGAAAGTGCGGGTATCG	TTGGCTGGTTCAGACTTCCGTC
Pig7Fw:Pig113Rv	AAGCTCGAAAGTGCGGGTATCG	GTTTACAACCCATAGGGCCGTC
Pig7Fw:Pig114Rv	AAGCTCGAAAGTGCGGGTATCG	TTGGCTGGTTCAGACTTACGTC
Pig7Fw:Pig115Rv	AAGCTCGAAAGTGCGGGTATCG	CACCACGAATTCCGCCTACCTC
Pig7Fw:Pig116Rv	AAGCTCGAAAGTGCGGGTATCG	AATCGGAGTTCTTCGTGATATC
Pig7Fw:Pig117Rv	AAGCTCGAAAGTGCGGGTATCG	CACTGGTGTTCCTCCTAATATC
Pig7Fw:Pig118Rv	AAGCTCGAAAGTGCGGGTATCG	TACAACCCATAGGGCCGTCATC
Pig7Fw:Pig119Rv	AAGCTCGAAAGTGCGGGTATCG	ACGGTAAGCTGCCTTCGCAATC
Pig7Fw:Pig120Rv	AAGCTCGAAAGTGCGGGTATCG	AGTAAATCCGGACAACGCTTGC
Pig7Fw:Pig121Rv	AAGCTCGAAAGTGCGGGTATCG	GCCTTCGCAATCGGAGTTCTGC
Pig7Fw:Pig122Rv	AAGCTCGAAAGTGCGGGTATCG	ACCTACGTATTACCGCGGCTGC
Pig7Fw:Pig123Rv	AAGCTCGAAAGTGCGGGTATCG	TCCTTATTCATGCGGTACCTGC
Pig7Fw:Pig124Rv	AAGCTCGAAAGTGCGGGTATCG	ATTAGCCGGTCCTTATTCATGC
Pig7Fw:Pig125Rv	AAGCTCGAAAGTGCGGGTATCG	GTCATCCTGCACGCTACTTGGC
Pig7Fw:Pig126Rv	AAGCTCGAAAGTGCGGGTATCG	AGCAGTTTACAACCCATAGGGC
Pig7Fw:Pig127Rv	AAGCTCGAAAGTGCGGGTATCG	CTCGCATCCTCCGTATTACCGC
Pig7Fw:Pig128Rv	AAGCTCGAAAGTGCGGGTATCG	CTTGCCACCTACGTATTACCGC
Pig7Fw:Pig129Rv	AAGCTCGAAAGTGCGGGTATCG	CTCGCCACCTACGTATTACCGC
Pig7Fw:Pig130Rv	AAGCTCGAAAGTGCGGGTATCG	TAATATCTACGCATTTCACCGC
Pig7Fw:Pig131Rv	AAGCTCGAAAGTGCGGGTATCG	TGATATCTAAGCATTTCACCGC
Pig7Fw:Pig132Rv	AAGCTCGAAAGTGCGGGTATCG	GTGTTCCTCCTAATATCTACGC
Pig7Fw:Pig133Rv	AAGCTCGAAAGTGCGGGTATCG	ACCCAGTAAATCCGGACAACGC
Pig7Fw:Pig134Rv	AAGCTCGAAAGTGCGGGTATCG	ACCCGCACTTTCGAGCTTCAGC
Pig7Fw:Pig135Rv	AAGCTCGAAAGTGCGGGTATCG	GAGTTCTTCGTGATATCTAAGC
Pig7Fw:Pig136Rv	AAGCTCGAAAGTGCGGGTATCG	TGGCTGGTTCAGACTTCCGTCC
Pig7Fw:Pig137Rv	AAGCTCGAAAGTGCGGGTATCG	TGGCTGGTTCAGACTTACGTCC
Pig7Fw:Pig138Rv	AAGCTCGAAAGTGCGGGTATCG	ACCACGAATTCCGCCTACCTCC
Pig7Fw:Pig139Rv	AAGCTCGAAAGTGCGGGTATCG	ACAACCCATAGGGCCGTCATCC
Pig7Fw:Pig140Rv	AAGCTCGAAAGTGCGGGTATCG	GCAGTTTACAACCCATAGGGCC
Pig7Fw:Pig141Rv	AAGCTCGAAAGTGCGGGTATCG	GGCCTACGCTCCCTTTAAACCC
Pig7Fw:Pig142Rv	AAGCTCGAAAGTGCGGGTATCG	CGCTCGCATCCTCCGTATTACC
Pig7Fw:Pig143Rv	AAGCTCGAAAGTGCGGGTATCG	CGCTTGCCACCTACGTATTACC
Pig7Fw:Pig144Rv	AAGCTCGAAAGTGCGGGTATCG	CGCTCGCCACCTACGTATTACC
Pig7Fw:Pig145Rv	AAGCTCGAAAGTGCGGGTATCG	TACACCACGAATTCCGCCTACC
Pig7Fw:Pig146Rv	AAGCTCGAAAGTGCGGGTATCG	TTCAGACTTCCGTCCATTGACC
Pig7Fw:Pig147Rv	AAGCTCGAAAGTGCGGGTATCG	TTCAGACTTACGTCCATTGACC
Pig7Fw:Pig148Rv	AAGCTCGAAAGTGCGGGTATCG	CCTAATATCTACGCATTTCACC
Pig7Fw:Pig149Rv	AAGCTCGAAAGTGCGGGTATCG	CGGCCTACGCTCCCTTTAAACC
Pig7Fw:Pig150Rv	AAGCTCGAAAGTGCGGGTATCG	ACGCTCGCATCCTCCGTATTAC
Pig7Fw:Pig151Rv	AAGCTCGAAAGTGCGGGTATCG	ACGCTTGCCACCTACGTATTAC
Pig7Fw:Pig152Rv	AAGCTCGAAAGTGCGGGTATCG	ACGCTCGCCACCTACGTATTAC
Pig7Fw:Pig153Rv	AAGCTCGAAAGTGCGGGTATCG	TGGTGTTCCTCCTAATATCTAC
Pig7Fw:Pig154Rv	AAGCTCGAAAGTGCGGGTATCG	TATCTATGCATTTCACCGCTAC
Pig7Fw:Pig155Rv	AAGCTCGAAAGTGCGGGTATCG	TATCTAAGCATTTCACCGCTAC
Pig7Fw:Pig156Rv	AAGCTCGAAAGTGCGGGTATCG	GTTCAGACTTCCGTCCATTGAC
Pig7Fw:Pig157Rv	AAGCTCGAAAGTGCGGGTATCG	GTTCAGACTTACGTCCATTGAC
Pig7Fw:Pig158Rv	AAGCTCGAAAGTGCGGGTATCG	ACGCTACTTGGCTGGTTCAGAC
Pig7Fw:Pig159Rv	AAGCTCGAAAGTGCGGGTATCG	TCTATGCATTTCACCGCTACAC
Pig7Fw:Pig160Rv	AAGCTCGAAAGTGCGGGTATCG	TCTAAGCATTTCACCGCTACAC
Pig7Fw:Pig161Rv	AAGCTCGAAAGTGCGGGTATCG	ACACCCAGTAAATCCGGACAAC
Pig7Fw:Pig162Rv	AAGCTCGAAAGTGCGGGTATCG	CCGGCCTACGCTCCCTTTAAAC
Pig7Fw:Pig163Rv	AAGCTCGAAAGTGCGGGTATCG	ACGGCCTACGCTCCCTTTAAAC
Pig7Fw:Pig164Rv	AAGCTCGAAAGTGCGGGTATCG	AAGCCGGCCTACGCTCCCTTTA
Pig7Fw:Pig165Rv	AAGCTCGAAAGTGCGGGTATCG	GCGGCATTTCACAACACGCTTA
Pig7Fw:Pig166Rv	AAGCTCGAAAGTGCGGGTATCG	GCACGGAATTAGCCGGTCCTTA
Pig7Fw:Pig167Rv	AAGCTCGAAAGTGCGGGTATCG	AACGCTCGCATCCTCCGTATTA
Pig7Fw:Pig168Rv	AAGCTCGAAAGTGCGGGTATCG	AACGCTTGCCACCTACGTATTA
Pig7Fw:Pig169Rv	AAGCTCGAAAGTGCGGGTATCG	AACGCTCGCCACCTACGTATTA
Pig7Fw:Pig170Rv	AAGCTCGAAAGTGCGGGTATCG	GATAACGCTCGCATCCTCCGTA
Pig7Fw:Pig171Rv	AAGCTCGAAAGTGCGGGTATCG	GACAACGCTTGCCACCTACGTA
Pig7Fw:Pig172Rv	AAGCTCGAAAGTGCGGGTATCG	TCGGAGTTCTTCGTGATATCTA
Pig7Fw:Pig173Rv	AAGCTCGAAAGTGCGGGTATCG	CTGGTGTTCCTCCTAATATCTA
Pig7Fw:Pig174Rv	AAGCTCGAAAGTGCGGGTATCG	ATATCTACGCATTTCACCGCTA
Pig7Fw:Pig175Rv	AAGCTCGAAAGTGCGGGTATCG	TTCGCCACTGGTGTTCCTCCTA
Pig7Fw:Pig176Rv	AAGCTCGAAAGTGCGGGTATCG	GCTACACCACGAATTCCGCCTA
Pig7Fw:Pig177Rv	AAGCTCGAAAGTGCGGGTATCG	TCCGGACAACGCTTGCCACCTA
Pig7Fw:Pig178Rv	AAGCTCGAAAGTGCGGGTATCG	TACGCATTTCACCGCTACACTA
Pig7Fw:Pig179Rv	AAGCTCGAAAGTGCGGGTATCG	GCAATCGGAGTTCTTCGTGATA
Pig7Fw:Pig180Rv	AAGCTCGAAAGTGCGGGTATCG	GCCACTGGTGTTCCTCCTAATA
Pig7Fw:Pig181Rv	AAGCTCGAAAGTGCGGGTATCG	TACGCTCCCTTTAAACCCAATA
Pig7Fw:Pig182Rv	AAGCTCGAAAGTGCGGGTATCG	GGTTCAGACTTCCGTCCATTGA
Pig7Fw:Pig183Rv	AAGCTCGAAAGTGCGGGTATCG	GGTTCAGACTTACGTCCATTGA
Pig7Fw:Pig184Rv	AAGCTCGAAAGTGCGGGTATCG	TCGCAATCGGAGTTCTTCGTGA
Pig7Fw:Pig185Rv	AAGCTCGAAAGTGCGGGTATCG	GTAAGCTGCCTTCGCAATCGGA
Pig7Fw:Pig186Rv	AAGCTCGAAAGTGCGGGTATCG	GCATTTCACCGCTACACTAGGA
Pig7Fw:Pig187Rv	AAGCTCGAAAGTGCGGGTATCG	CACGCTACTTGGCTGGTTCAGA
Pig7Fw:Pig188Rv	AAGCTCGAAAGTGCGGGTATCG	TGCACGCTACTTGGCTGGTTCA
Pig7Fw:Pig189Rv	AAGCTCGAAAGTGCGGGTATCG	ATACCCGCACTTTCGAGCTTCA
Pig7Fw:Pig190Rv	AAGCTCGAAAGTGCGGGTATCG	GCACTTTCGAGCTTCAGCGTCA
Pig7Fw:Pig191Rv	AAGCTCGAAAGTGCGGGTATCG	TTTACAACCCATAGGGCCGTCA
Pig7Fw:Pig192Rv	AAGCTCGAAAGTGCGGGTATCG	CCTTATTCATGCGGTACCTGCA
Pig7Fw:Pig193Rv	AAGCTCGAAAGTGCGGGTATCG	GCTACGGTAAGCTGCCTTCGCA
Pig7Fw:Pig194Rv	AAGCTCGAAAGTGCGGGTATCG	TGTTCCTCCTAATATCTACGCA
Pig7Fw:Pig195Rv	AAGCTCGAAAGTGCGGGTATCG	GGCTGGTTCAGACTTCCGTCCA
Pig7Fw:Pig196Rv	AAGCTCGAAAGTGCGGGTATCG	GGCTGGTTCAGACTTACGTCCA
Pig7Fw:Pig197Rv	AAGCTCGAAAGTGCGGGTATCG	GCCTACGCTCCCTTTAAACCCA
Pig7Fw:Pig198Rv	AAGCTCGAAAGTGCGGGTATCG	TCAGACTTCCGTCCATTGACCA
Pig7Fw:Pig199Rv	AAGCTCGAAAGTGCGGGTATCG	TCAGACTTACGTCCATTGACCA
Pig7Fw:Pig200Rv	AAGCTCGAAAGTGCGGGTATCG	ATCTATGCATTTCACCGCTACA
Pig7Fw:Pig201Rv	AAGCTCGAAAGTGCGGGTATCG	ATCTAAGCATTTCACCGCTACA
Pig7Fw:Pig202Rv	AAGCTCGAAAGTGCGGGTATCG	AGCCGGCCTACGCTCCCTTTAA
Pig7Fw:Pig203Rv	AAGCTCGAAAGTGCGGGTATCG	CGGCATTTCACAACACGCTTAA
Pig7Fw:Pig204Rv	AAGCTCGAAAGTGCGGGTATCG	CGGAGTTCTTCGTGATATCTAA
Pig7Fw:Pig205Rv	AAGCTCGAAAGTGCGGGTATCG	TCGCCACTGGTGTTCCTCCTAA
Pig7Fw:Pig206Rv	AAGCTCGAAAGTGCGGGTATCG	ACGCTCCCTTTAAACCCAATAA
Pig7Fw:Pig207Rv	AAGCTCGAAAGTGCGGGTATCG	CATTTCACCGCTACACTAGGAA
Pig7Fw:Pig208Rv	AAGCTCGAAAGTGCGGGTATCG	CTTATTCATGCGGTACCTGCAA
Pig7Fw:Pig209Rv	AAGCTCGAAAGTGCGGGTATCG	CTACGGTAAGCTGCCTTCGCAA
Pig7Fw:Pig210Rv	AAGCTCGAAAGTGCGGGTATCG	CCTACGCTCCCTTTAAACCCAA
Pig7Fw:Pig211Rv	AAGCTCGAAAGTGCGGGTATCG	CAGACTTCCGTCCATTGACCAA
Pig7Fw:Pig212Rv	AAGCTCGAAAGTGCGGGTATCG	CAGACTTACGTCCATTGACCAA
Pig7Fw:Pig213Rv	AAGCTCGAAAGTGCGGGTATCG	TACACCCAGTAAATCCGGACAA
Pig7Fw:Pig214Rv	AAGCTCGAAAGTGCGGGTATCG	GCCGGCCTACGCTCCCTTTAAA
Pig7Fw:Pig215Rv	AAGCTCGAAAGTGCGGGTATCG	GGCATTTCACAACACGCTTAAA
Pig7Fw:Pig216Rv	AAGCTCGAAAGTGCGGGTATCG	TTATTCATGCGGTACCTGCAAA
Pig7Fw:Pig217Rv	AAGCTCGAAAGTGCGGGTATCG	GCACGGAGTTAGCCGATGCTTT
Pig7Fw:Pig218Rv	AAGCTCGAAAGTGCGGGTATCG	CCTTCACGCGACTTGGCTGGTT
Pig7Fw:Pig219Rv	AAGCTCGAAAGTGCGGGTATCG	ACGGAGTTAGCCGATGCTTATT
Pig7Fw:Pig220Rv	AAGCTCGAAAGTGCGGGTATCG	CAACGCTCGCCACCTACGTATT
Pig7Fw:Pig221Rv	AAGCTCGAAAGTGCGGGTATCG	TTTCACCGCTACACAACGCATT
Pig7Fw:Pig222Rv	AAGCTCGAAAGTGCGGGTATCG	CTGGTTCAGGCTCTCGCCCATT
Pig7Fw:Pig223Rv	AAGCTCGAAAGTGCGGGTATCG	TTTCACCGCTACACGACGAATT
Pig7Fw:Pig224Rv	AAGCTCGAAAGTGCGGGTATCG	TCCTTCACGCGACTTGGCTGGT
Pig7Fw:Pig225Rv	AAGCTCGAAAGTGCGGGTATCG	ATCGGAGTTCTGCGTCATATCT
Pig7Fw:Pig226Rv	AAGCTCGAAAGTGCGGGTATCG	TCGTCCTGCACGCTACTTGGCT
Pig7Fw:Pig227Rv	AAGCTCGAAAGTGCGGGTATCG	CCCAGTAATTCCGGACAACGCT
Pig7Fw:Pig228Rv	AAGCTCGAAAGTGCGGGTATCG	ATCCGGACAACGCTTGCCACCT
Pig7Fw:Pig229Rv	AAGCTCGAAAGTGCGGGTATCG	CACGGAGTTAGCCGATGCTTAT
Pig7Fw:Pig230Rv	AAGCTCGAAAGTGCGGGTATCG	ACAACGCTCGCCACCTACGTAT
Pig7Fw:Pig231Rv	AAGCTCGAAAGTGCGGGTATCG	CGGAGTTCTGCGTCATATCTAT
Pig7Fw:Pig232Rv	AAGCTCGAAAGTGCGGGTATCG	CAATCGGAGTTCTGCGTCATAT
Pig7Fw:Pig233Rv	AAGCTCGAAAGTGCGGGTATCG	ATTTCACCGCTACACAACGCAT
Pig7Fw:Pig234Rv	AAGCTCGAAAGTGCGGGTATCG	ATTTCACCGCTACACGACGAAT
Pig7Fw:Pig235Rv	AAGCTCGAAAGTGCGGGTATCG	TGGTTCAGGCTCTCGCCCATTG
Pig7Fw:Pig236Rv	AAGCTCGAAAGTGCGGGTATCG	AAAGAGGTTTACAATCCGTAGG
Pig7Fw:Pig237Rv	AAGCTCGAAAGTGCGGGTATCG	CACGCTACTTGGCTGGTTCAGG
Pig7Fw:Pig238Rv	AAGCTCGAAAGTGCGGGTATCG	CACCGCTACACAACGCATTCCG
Pig7Fw:Pig239Rv	AAGCTCGAAAGTGCGGGTATCG	CCCTTTACGCCCAATAATTCCG
Pig7Fw:Pig240Rv	AAGCTCGAAAGTGCGGGTATCG	CACCGCTACACGACGAATTCCG
Pig7Fw:Pig241Rv	AAGCTCGAAAGTGCGGGTATCG	GTCATATCTAAGCATTTCACCG
Pig7Fw:Pig242Rv	AAGCTCGAAAGTGCGGGTATCG	AGCATTTCACCGCTACACGACG
Pig7Fw:Pig243Rv	AAGCTCGAAAGTGCGGGTATCG	CTAAGCATTTCACCGCTACACG
Pig7Fw:Pig244Rv	AAGCTCGAAAGTGCGGGTATCG	CACCCAGTAATTCCGGACAACG
Pig7Fw:Pig245Rv	AAGCTCGAAAGTGCGGGTATCG	TGCATTTCACCGCTACACAACG
Pig7Fw:Pig246Rv	AAGCTCGAAAGTGCGGGTATCG	CAAGCTGCCTTCGCAATCGGAG
Pig7Fw:Pig247Rv	AAGCTCGAAAGTGCGGGTATCG	CTTCACGCGACTTGGCTGGTTC
Pig7Fw:Pig248Rv	AAGCTCGAAAGTGCGGGTATCG	CGGAGTTAGCCGATGCTTATTC
Pig7Fw:Pig249Rv	AAGCTCGAAAGTGCGGGTATCG	TTCACCGCTACACAACGCATTC
Pig7Fw:Pig250Rv	AAGCTCGAAAGTGCGGGTATCG	TTCACCGCTACACGACGAATTC
Pig7Fw:Pig251Rv	AAGCTCGAAAGTGCGGGTATCG	AATCGGAGTTCTGCGTCATATC
Pig7Fw:Pig252Rv	AAGCTCGAAAGTGCGGGTATCG	ACGCTACTTGGCTGGTTCAGGC
Pig7Fw:Pig253Rv	AAGCTCGAAAGTGCGGGTATCG	TCATATCTAAGCATTTCACCGC
Pig7Fw:Pig254Rv	AAGCTCGAAAGTGCGGGTATCG	ACCCAGTAATTCCGGACAACGC
Pig7Fw:Pig255Rv	AAGCTCGAAAGTGCGGGTATCG	GCATTTCACCGCTACACAACGC
Pig7Fw:Pig256Rv	AAGCTCGAAAGTGCGGGTATCG	TCACCGCTACACAACGCATTCC
Pig7Fw:Pig257Rv	AAGCTCGAAAGTGCGGGTATCG	TCACCGCTACACGACGAATTCC
Pig7Fw:Pig258Rv	AAGCTCGAAAGTGCGGGTATCG	GTAAATCCGGACAACGCTTGCC
Pig7Fw:Pig259Rv	AAGCTCGAAAGTGCGGGTATCG	TTCAGGCTCTCGCCCATTGACC
Pig7Fw:Pig260Rv	AAGCTCGAAAGTGCGGGTATCG	GAGGTTTACAATCCGTAGGACC
Pig7Fw:Pig261Rv	AAGCTCGAAAGTGCGGGTATCG	CGTCATATCTAAGCATTTCACC
Pig7Fw:Pig262Rv	AAGCTCGAAAGTGCGGGTATCG	AATCCGGACAACGCTTGCCACC
Pig7Fw:Pig263Rv	AAGCTCGAAAGTGCGGGTATCG	CCGCCTACGCACCCTTTAAACC
Pig7Fw:Pig264Rv	AAGCTCGAAAGTGCGGGTATCG	GTTCAGGCTCTCGCCCATTGAC
Pig7Fw:Pig265Rv	AAGCTCGAAAGTGCGGGTATCG	AGAGGTTTACAATCCGTAGGAC
Pig7Fw:Pig266Rv	AAGCTCGAAAGTGCGGGTATCG	AAGCATTTCACCGCTACACGAC
Pig7Fw:Pig267Rv	AAGCTCGAAAGTGCGGGTATCG	AAATCCGGACAACGCTTGCCAC
Pig7Fw:Pig268Rv	AAGCTCGAAAGTGCGGGTATCG	AATTCCGGACAACGCTCGCCAC
Pig7Fw:Pig269Rv	AAGCTCGAAAGTGCGGGTATCG	ACACCCAGTAATTCCGGACAAC
Pig7Fw:Pig270Rv	AAGCTCGAAAGTGCGGGTATCG	ATGCATTTCACCGCTACACAAC
Pig7Fw:Pig271Rv	AAGCTCGAAAGTGCGGGTATCG	GCACGGAGTTAGCCGATGCTTA
Pig7Fw:Pig272Rv	AAGCTCGAAAGTGCGGGTATCG	GACAACGCTCGCCACCTACGTA
Pig7Fw:Pig273Rv	AAGCTCGAAAGTGCGGGTATCG	TCGGAGTTCTGCGTCATATCTA
Pig7Fw:Pig274Rv	AAGCTCGAAAGTGCGGGTATCG	GCAATCGGAGTTCTGCGTCATA
Pig7Fw:Pig275Rv	AAGCTCGAAAGTGCGGGTATCG	GGTTCAGGCTCTCGCCCATTGA
Pig7Fw:Pig276Rv	AAGCTCGAAAGTGCGGGTATCG	CTTTACGCCCAATAATTCCGGA
Pig7Fw:Pig277Rv	AAGCTCGAAAGTGCGGGTATCG	AAGAGGTTTACAATCCGTAGGA
Pig7Fw:Pig278Rv	AAGCTCGAAAGTGCGGGTATCG	GCATTTCACCGCTACACGACGA
Pig7Fw:Pig279Rv	AAGCTCGAAAGTGCGGGTATCG	TAAGCATTTCACCGCTACACGA
Pig7Fw:Pig280Rv	AAGCTCGAAAGTGCGGGTATCG	CTCACGCGACTTGGCTGGTTCA
Pig7Fw:Pig281Rv	AAGCTCGAAAGTGCGGGTATCG	CATTTCACCGCTACACAACGCA
Pig7Fw:Pig282Rv	AAGCTCGAAAGTGCGGGTATCG	TAAATCCGGACAACGCTTGCCA
Pig7Fw:Pig283Rv	AAGCTCGAAAGTGCGGGTATCG	TAATTCCGGACAACGCTCGCCA
Pig7Fw:Pig284Rv	AAGCTCGAAAGTGCGGGTATCG	TCAGGCTCTCGCCCATTGACCA
Pig7Fw:Pig285Rv	AAGCTCGAAAGTGCGGGTATCG	CTATGCATTTCACCGCTACACA
Pig7Fw:Pig286Rv	AAGCTCGAAAGTGCGGGTATCG	CATTTCACCGCTACACGACGAA
Pig7Fw:Pig287Rv	AAGCTCGAAAGTGCGGGTATCG	CAGGCTCTCGCCCATTGACCAA
Pig7Fw:Pig288Rv	AAGCTCGAAAGTGCGGGTATCG	TACACCCAGTAATTCCGGACAA
Pig7Fw:Pig289Rv	AAGCTCGAAAGTGCGGGTATCG	TATGCATTTCACCGCTACACAA
Pig9Fw:Pig1Rv	AAGGCAGCTTACCGTAGCGTTA	CCTGCACGCTACTTGGCTGGTT
Pig9Fw:Pig2Rv	AAGGCAGCTTACCGTAGCGTTA	AGCTGCCTTCGCAATCGGAGTT
Pig9Fw:Pig3Rv	AAGGCAGCTTACCGTAGCGTTA	TGCCTTCGCAATCGGAGTTCTT
Pig9Fw:Pig4Rv	AAGGCAGCTTACCGTAGCGTTA	GGCACGGAGTTAGCCGATGCTT
Pig9Fw:Pig5Rv	AAGGCAGCTTACCGTAGCGTTA	CGCGGCATTTCACAACACGCTT
Pig9Fw:Pig6Rv	AAGGCAGCTTACCGTAGCGTTA	CCAGTAAATCCGGACAACGCTT
Pig9Fw:Pig7Rv	AAGGCAGCTTACCGTAGCGTTA	CGATACCCGCACTTTCGAGCTT
Pig9Fw:Pig8Rv	AAGGCAGCTTACCGTAGCGTTA	GGCACGGAATTAGCCGGTCCTT
Pig9Fw:Pig9Rv	AAGGCAGCTTACCGTAGCGTTA	TAACGCTACGGTAAGCTGCCTT
Pig9Fw:Pig10Rv	AAGGCAGCTTACCGTAGCGTTA	GCCGTCATCCTGCACGCTACTT
Pig9Fw:Pig11Rv	AAGGCAGCTTACCGTAGCGTTA	ACGGAATTAGCCGGTCCTTATT
Pig9Fw:Pig12Rv	AAGGCAGCTTACCGTAGCGTTA	TAACGCTCGCATCCTCCGTATT
Pig9Fw:Pig13Rv	AAGGCAGCTTACCGTAGCGTTA	CAACGCTTGCCACCTACGTATT
Pig9Fw:Pig14Rv	AAGGCAGCTTACCGTAGCGTTA	CTGGTTCAGACTTCCGTCCATT
Pig9Fw:Pig15Rv	AAGGCAGCTTACCGTAGCGTTA	CTGGTTCAGACTTACGTCCATT
Pig9Fw:Pig16Rv	AAGGCAGCTTACCGTAGCGTTA	TTTCACCGCTACACTAGGAATT
Pig9Fw:Pig17Rv	AAGGCAGCTTACCGTAGCGTTA	TCCTGCACGCTACTTGGCTGGT
Pig9Fw:Pig18Rv	AAGGCAGCTTACCGTAGCGTTA	TGCTGGCACGGAATTAGCCGGT
Pig9Fw:Pig19Rv	AAGGCAGCTTACCGTAGCGTTA	CCGCACTTTCGAGCTTCAGCGT
Pig9Fw:Pig20Rv	AAGGCAGCTTACCGTAGCGTTA	CTTGGCTGGTTCAGACTTCCGT
Pig9Fw:Pig21Rv	AAGGCAGCTTACCGTAGCGTTA	AGTTTACAACCCATAGGGCCGT
Pig9Fw:Pig22Rv	AAGGCAGCTTACCGTAGCGTTA	CTGCTGGCACGTAGTTAGCCGT
Pig9Fw:Pig23Rv	AAGGCAGCTTACCGTAGCGTTA	CTTGGCTGGTTCAGACTTACGT
Pig9Fw:Pig24Rv	AAGGCAGCTTACCGTAGCGTTA	GGACAACGCTTGCCACCTACGT
Pig9Fw:Pig25Rv	AAGGCAGCTTACCGTAGCGTTA	AAGCTGCCTTCGCAATCGGAGT
Pig9Fw:Pig26Rv	AAGGCAGCTTACCGTAGCGTTA	CTGCCTTCGCAATCGGAGTTCT
Pig9Fw:Pig27Rv	AAGGCAGCTTACCGTAGCGTTA	ATCGGAGTTCTTCGTGATATCT
Pig9Fw:Pig28Rv	AAGGCAGCTTACCGTAGCGTTA	ACTGGTGTTCCTCCTAATATCT
Pig9Fw:Pig29Rv	AAGGCAGCTTACCGTAGCGTTA	CTTCCGTATTACCGCGGCTGCT
Pig9Fw:Pig30Rv	AAGGCAGCTTACCGTAGCGTTA	CCTACGTATTACCGCGGCTGCT
Pig9Fw:Pig31Rv	AAGGCAGCTTACCGTAGCGTTA	TGGCACGGAGTTAGCCGATGCT
Pig9Fw:Pig32Rv	AAGGCAGCTTACCGTAGCGTTA	TCATCCTGCACGCTACTTGGCT
Pig9Fw:Pig33Rv	AAGGCAGCTTACCGTAGCGTTA	GACCTTCCGTATTACCGCGGCT
Pig9Fw:Pig34Rv	AAGGCAGCTTACCGTAGCGTTA	CATCCTCCGTATTACCGCGGCT
Pig9Fw:Pig35Rv	AAGGCAGCTTACCGTAGCGTTA	CCACCTACGTATTACCGCGGCT
Pig9Fw:Pig36Rv	AAGGCAGCTTACCGTAGCGTTA	AATATCTACGCATTTCACCGCT
Pig9Fw:Pig37Rv	AAGGCAGCTTACCGTAGCGTTA	GATATCTAAGCATTTCACCGCT
Pig9Fw:Pig38Rv	AAGGCAGCTTACCGTAGCGTTA	CATATCTAAGCATTTCACCGCT
Pig9Fw:Pig39Rv	AAGGCAGCTTACCGTAGCGTTA	CCGCGGCATTTCACAACACGCT
Pig9Fw:Pig40Rv	AAGGCAGCTTACCGTAGCGTTA	CCCAGTAAATCCGGACAACGCT
Pig9Fw:Pig41Rv	AAGGCAGCTTACCGTAGCGTTA	TGGCACGGAATTAGCCGGTCCT
Pig9Fw:Pig42Rv	AAGGCAGCTTACCGTAGCGTTA	CTTCGCCACTGGTGTTCCTCCT
Pig9Fw:Pig43Rv	AAGGCAGCTTACCGTAGCGTTA	CAACCCATAGGGCCGTCATCCT
Pig9Fw:Pig44Rv	AAGGCAGCTTACCGTAGCGTTA	CGCTACACCACGAATTCCGCCT
Pig9Fw:Pig45Rv	AAGGCAGCTTACCGTAGCGTTA	GGTCCTTATTCATGCGGTACCT
Pig9Fw:Pig46Rv	AAGGCAGCTTACCGTAGCGTTA	ACACCACGAATTCCGCCTACCT
Pig9Fw:Pig47Rv	AAGGCAGCTTACCGTAGCGTTA	CGCTACTTGGCTGGTTCAGACT
Pig9Fw:Pig48Rv	AAGGCAGCTTACCGTAGCGTTA	CACGGAATTAGCCGGTCCTTAT
Pig9Fw:Pig49Rv	AAGGCAGCTTACCGTAGCGTTA	ATAACGCTCGCATCCTCCGTAT
Pig9Fw:Pig50Rv	AAGGCAGCTTACCGTAGCGTTA	ACAACGCTTGCCACCTACGTAT
Pig9Fw:Pig51Rv	AAGGCAGCTTACCGTAGCGTTA	CAATCGGAGTTCTTCGTGATAT
Pig9Fw:Pig52Rv	AAGGCAGCTTACCGTAGCGTTA	CCACTGGTGTTCCTCCTAATAT
Pig9Fw:Pig53Rv	AAGGCAGCTTACCGTAGCGTTA	CGCAATCGGAGTTCTTCGTGAT
Pig9Fw:Pig54Rv	AAGGCAGCTTACCGTAGCGTTA	TGCTGGCACGGAGTTAGCCGAT
Pig9Fw:Pig55Rv	AAGGCAGCTTACCGTAGCGTTA	TTACAACCCATAGGGCCGTCAT
Pig9Fw:Pig56Rv	AAGGCAGCTTACCGTAGCGTTA	GTTCCTCCTAATATCTACGCAT
Pig9Fw:Pig57Rv	AAGGCAGCTTACCGTAGCGTTA	GCTGGTTCAGACTTCCGTCCAT
Pig9Fw:Pig58Rv	AAGGCAGCTTACCGTAGCGTTA	GCTGGTTCAGACTTACGTCCAT
Pig9Fw:Pig59Rv	AAGGCAGCTTACCGTAGCGTTA	CGCCACTGGTGTTCCTCCTAAT
Pig9Fw:Pig60Rv	AAGGCAGCTTACCGTAGCGTTA	ATTTCACCGCTACACTAGGAAT
Pig9Fw:Pig61Rv	AAGGCAGCTTACCGTAGCGTTA	TACGGTAAGCTGCCTTCGCAAT
Pig9Fw:Pig62Rv	AAGGCAGCTTACCGTAGCGTTA	CTACGCTCCCTTTAAACCCAAT
Pig9Fw:Pig63Rv	AAGGCAGCTTACCGTAGCGTTA	CAGTAAATCCGGACAACGCTTG
Pig9Fw:Pig64Rv	AAGGCAGCTTACCGTAGCGTTA	CCGTCATCCTGCACGCTACTTG
Pig9Fw:Pig65Rv	AAGGCAGCTTACCGTAGCGTTA	TGGTTCAGACTTCCGTCCATTG
Pig9Fw:Pig66Rv	AAGGCAGCTTACCGTAGCGTTA	TGGTTCAGACTTACGTCCATTG
Pig9Fw:Pig67Rv	AAGGCAGCTTACCGTAGCGTTA	TGCCTTCGCAATCGGAGTTCTG
Pig9Fw:Pig68Rv	AAGGCAGCTTACCGTAGCGTTA	TTCCGTATTACCGCGGCTGCTG
Pig9Fw:Pig69Rv	AAGGCAGCTTACCGTAGCGTTA	CTACGTATTACCGCGGCTGCTG
Pig9Fw:Pig70Rv	AAGGCAGCTTACCGTAGCGTTA	CATCCTGCACGCTACTTGGCTG
Pig9Fw:Pig71Rv	AAGGCAGCTTACCGTAGCGTTA	ACCTTCCGTATTACCGCGGCTG
Pig9Fw:Pig72Rv	AAGGCAGCTTACCGTAGCGTTA	ATCCTCCGTATTACCGCGGCTG
Pig9Fw:Pig73Rv	AAGGCAGCTTACCGTAGCGTTA	CACCTACGTATTACCGCGGCTG
Pig9Fw:Pig74Rv	AAGGCAGCTTACCGTAGCGTTA	AACCCATAGGGCCGTCATCCTG
Pig9Fw:Pig75Rv	AAGGCAGCTTACCGTAGCGTTA	GTCCTTATTCATGCGGTACCTG
Pig9Fw:Pig76Rv	AAGGCAGCTTACCGTAGCGTTA	AATTAGCCGGTCCTTATTCATG
Pig9Fw:Pig77Rv	AAGGCAGCTTACCGTAGCGTTA	CGTCATCCTGCACGCTACTTGG
Pig9Fw:Pig78Rv	AAGGCAGCTTACCGTAGCGTTA	TACGTATTACCGCGGCTGCTGG
Pig9Fw:Pig79Rv	AAGGCAGCTTACCGTAGCGTTA	ATCCTGCACGCTACTTGGCTGG
Pig9Fw:Pig80Rv	AAGGCAGCTTACCGTAGCGTTA	AAGCAGTTTACAACCCATAGGG
Pig9Fw:Pig81Rv	AAGGCAGCTTACCGTAGCGTTA	GGTAAGCTGCCTTCGCAATCGG
Pig9Fw:Pig82Rv	AAGGCAGCTTACCGTAGCGTTA	TAGCCGGTCCTTATTCATGCGG
Pig9Fw:Pig83Rv	AAGGCAGCTTACCGTAGCGTTA	TGCCACCTACGTATTACCGCGG
Pig9Fw:Pig84Rv	AAGGCAGCTTACCGTAGCGTTA	CGCATTTCACCGCTACACTAGG
Pig9Fw:Pig85Rv	AAGGCAGCTTACCGTAGCGTTA	AAAGCAGTTTACAACCCATAGG
Pig9Fw:Pig86Rv	AAGGCAGCTTACCGTAGCGTTA	ACGCTACGGTAAGCTGCCTTCG
Pig9Fw:Pig87Rv	AAGGCAGCTTACCGTAGCGTTA	CGGTAAGCTGCCTTCGCAATCG
Pig9Fw:Pig88Rv	AAGGCAGCTTACCGTAGCGTTA	TTAGCCGGTCCTTATTCATGCG
Pig9Fw:Pig89Rv	AAGGCAGCTTACCGTAGCGTTA	TCGCATCCTCCGTATTACCGCG
Pig9Fw:Pig90Rv	AAGGCAGCTTACCGTAGCGTTA	TTGCCACCTACGTATTACCGCG
Pig9Fw:Pig91Rv	AAGGCAGCTTACCGTAGCGTTA	TCGCCACCTACGTATTACCGCG
Pig9Fw:Pig92Rv	AAGGCAGCTTACCGTAGCGTTA	CAGTTTACAACCCATAGGGCCG
Pig9Fw:Pig93Rv	AAGGCAGCTTACCGTAGCGTTA	GCTCGCATCCTCCGTATTACCG
Pig9Fw:Pig94Rv	AAGGCAGCTTACCGTAGCGTTA	GCTTGCCACCTACGTATTACCG
Pig9Fw:Pig95Rv	AAGGCAGCTTACCGTAGCGTTA	GCTCGCCACCTACGTATTACCG
Pig9Fw:Pig96Rv	AAGGCAGCTTACCGTAGCGTTA	CTAATATCTACGCATTTCACCG
Pig9Fw:Pig97Rv	AAGGCAGCTTACCGTAGCGTTA	GGTGTTCCTCCTAATATCTACG
Pig9Fw:Pig98Rv	AAGGCAGCTTACCGTAGCGTTA	CACCCAGTAAATCCGGACAACG
Pig9Fw:Pig99Rv	AAGGCAGCTTACCGTAGCGTTA	ACGCATTTCACCGCTACACTAG
Pig9Fw:Pig100Rv	AAGGCAGCTTACCGTAGCGTTA	TAAGCTGCCTTCGCAATCGGAG
Pig9Fw:Pig101Rv	AAGGCAGCTTACCGTAGCGTTA	GCACGCTACTTGGCTGGTTCAG
Pig9Fw:Pig102Rv	AAGGCAGCTTACCGTAGCGTTA	TCACGCGACTTGGCTGGTTCAG
Pig9Fw:Pig103Rv	AAGGCAGCTTACCGTAGCGTTA	TACCCGCACTTTCGAGCTTCAG
Pig9Fw:Pig104Rv	AAGGCAGCTTACCGTAGCGTTA	GGAGTTCTTCGTGATATCTAAG
Pig9Fw:Pig105Rv	AAGGCAGCTTACCGTAGCGTTA	CCTCCTAATATCTACGCATTTC
Pig9Fw:Pig106Rv	AAGGCAGCTTACCGTAGCGTTA	CTGCACGCTACTTGGCTGGTTC
Pig9Fw:Pig107Rv	AAGGCAGCTTACCGTAGCGTTA	GCTGCCTTCGCAATCGGAGTTC
Pig9Fw:Pig108Rv	AAGGCAGCTTACCGTAGCGTTA	GATACCCGCACTTTCGAGCTTC
Pig9Fw:Pig109Rv	AAGGCAGCTTACCGTAGCGTTA	AACGCTACGGTAAGCTGCCTTC
Pig9Fw:Pig110Rv	AAGGCAGCTTACCGTAGCGTTA	TTCACCGCTACACTAGGAATTC
Pig9Fw:Pig111Rv	AAGGCAGCTTACCGTAGCGTTA	CGCACTTTCGAGCTTCAGCGTC
Pig9Fw:Pig112Rv	AAGGCAGCTTACCGTAGCGTTA	TTGGCTGGTTCAGACTTCCGTC
Pig9Fw:Pig113Rv	AAGGCAGCTTACCGTAGCGTTA	GTTTACAACCCATAGGGCCGTC
Pig9Fw:Pig114Rv	AAGGCAGCTTACCGTAGCGTTA	TTGGCTGGTTCAGACTTACGTC
Pig9Fw:Pig115Rv	AAGGCAGCTTACCGTAGCGTTA	CACCACGAATTCCGCCTACCTC
Pig9Fw:Pig116Rv	AAGGCAGCTTACCGTAGCGTTA	AATCGGAGTTCTTCGTGATATC
Pig9Fw:Pig117Rv	AAGGCAGCTTACCGTAGCGTTA	CACTGGTGTTCCTCCTAATATC
Pig9Fw:Pig118Rv	AAGGCAGCTTACCGTAGCGTTA	TACAACCCATAGGGCCGTCATC
Pig9Fw:Pig119Rv	AAGGCAGCTTACCGTAGCGTTA	ACGGTAAGCTGCCTTCGCAATC
Pig9Fw:Pig120Rv	AAGGCAGCTTACCGTAGCGTTA	AGTAAATCCGGACAACGCTTGC
Pig9Fw:Pig121Rv	AAGGCAGCTTACCGTAGCGTTA	GCCTTCGCAATCGGAGTTCTGC
Pig9Fw:Pig122Rv	AAGGCAGCTTACCGTAGCGTTA	ACCTACGTATTACCGCGGCTGC
Pig9Fw:Pig123Rv	AAGGCAGCTTACCGTAGCGTTA	TCCTTATTCATGCGGTACCTGC
Pig9Fw:Pig124Rv	AAGGCAGCTTACCGTAGCGTTA	ATTAGCCGGTCCTTATTCATGC
Pig9Fw:Pig125Rv	AAGGCAGCTTACCGTAGCGTTA	GTCATCCTGCACGCTACTTGGC
Pig9Fw:Pig126Rv	AAGGCAGCTTACCGTAGCGTTA	AGCAGTTTACAACCCATAGGGC
Pig9Fw:Pig127Rv	AAGGCAGCTTACCGTAGCGTTA	CTCGCATCCTCCGTATTACCGC
Pig9Fw:Pig128Rv	AAGGCAGCTTACCGTAGCGTTA	CTTGCCACCTACGTATTACCGC
Pig9Fw:Pig129Rv	AAGGCAGCTTACCGTAGCGTTA	CTCGCCACCTACGTATTACCGC
Pig9Fw:Pig130Rv	AAGGCAGCTTACCGTAGCGTTA	TAATATCTACGCATTTCACCGC
Pig9Fw:Pig131Rv	AAGGCAGCTTACCGTAGCGTTA	TGATATCTAAGCATTTCACCGC
Pig9Fw:Pig132Rv	AAGGCAGCTTACCGTAGCGTTA	GTGTTCCTCCTAATATCTACGC
Pig9Fw:Pig133Rv	AAGGCAGCTTACCGTAGCGTTA	ACCCAGTAAATCCGGACAACGC
Pig9Fw:Pig134Rv	AAGGCAGCTTACCGTAGCGTTA	ACCCGCACTTTCGAGCTTCAGC
Pig9Fw:Pig135Rv	AAGGCAGCTTACCGTAGCGTTA	GAGTTCTTCGTGATATCTAAGC
Pig9Fw:Pig136Rv	AAGGCAGCTTACCGTAGCGTTA	TGGCTGGTTCAGACTTCCGTCC
Pig9Fw:Pig137Rv	AAGGCAGCTTACCGTAGCGTTA	TGGCTGGTTCAGACTTACGTCC
Pig9Fw:Pig138Rv	AAGGCAGCTTACCGTAGCGTTA	ACCACGAATTCCGCCTACCTCC
Pig9Fw:Pig139Rv	AAGGCAGCTTACCGTAGCGTTA	ACAACCCATAGGGCCGTCATCC
Pig9Fw:Pig140Rv	AAGGCAGCTTACCGTAGCGTTA	GCAGTTTACAACCCATAGGGCC
Pig9Fw:Pig141Rv	AAGGCAGCTTACCGTAGCGTTA	GGCCTACGCTCCCTTTAAACCC
Pig9Fw:Pig142Rv	AAGGCAGCTTACCGTAGCGTTA	CGCTCGCATCCTCCGTATTACC
Pig9Fw:Pig143Rv	AAGGCAGCTTACCGTAGCGTTA	CGCTTGCCACCTACGTATTACC
Pig9Fw:Pig144Rv	AAGGCAGCTTACCGTAGCGTTA	CGCTCGCCACCTACGTATTACC
Pig9Fw:Pig145Rv	AAGGCAGCTTACCGTAGCGTTA	TACACCACGAATTCCGCCTACC
Pig9Fw:Pig146Rv	AAGGCAGCTTACCGTAGCGTTA	TTCAGACTTCCGTCCATTGACC
Pig9Fw:Pig147Rv	AAGGCAGCTTACCGTAGCGTTA	TTCAGACTTACGTCCATTGACC
Pig9Fw:Pig148Rv	AAGGCAGCTTACCGTAGCGTTA	CCTAATATCTACGCATTTCACC
Pig9Fw:Pig149Rv	AAGGCAGCTTACCGTAGCGTTA	CGGCCTACGCTCCCTTTAAACC
Pig9Fw:Pig150Rv	AAGGCAGCTTACCGTAGCGTTA	ACGCTCGCATCCTCCGTATTAC
Pig9Fw:Pig151Rv	AAGGCAGCTTACCGTAGCGTTA	ACGCTTGCCACCTACGTATTAC
Pig9Fw:Pig152Rv	AAGGCAGCTTACCGTAGCGTTA	ACGCTCGCCACCTACGTATTAC
Pig9Fw:Pig153Rv	AAGGCAGCTTACCGTAGCGTTA	TGGTGTTCCTCCTAATATCTAC
Pig9Fw:Pig154Rv	AAGGCAGCTTACCGTAGCGTTA	TATCTATGCATTTCACCGCTAC
Pig9Fw:Pig155Rv	AAGGCAGCTTACCGTAGCGTTA	TATCTAAGCATTTCACCGCTAC
Pig9Fw:Pig156Rv	AAGGCAGCTTACCGTAGCGTTA	GTTCAGACTTCCGTCCATTGAC
Pig9Fw:Pig157Rv	AAGGCAGCTTACCGTAGCGTTA	GTTCAGACTTACGTCCATTGAC
Pig9Fw:Pig158Rv	AAGGCAGCTTACCGTAGCGTTA	ACGCTACTTGGCTGGTTCAGAC
Pig9Fw:Pig159Rv	AAGGCAGCTTACCGTAGCGTTA	TCTATGCATTTCACCGCTACAC
Pig9Fw:Pig160Rv	AAGGCAGCTTACCGTAGCGTTA	TCTAAGCATTTCACCGCTACAC
Pig9Fw:Pig161Rv	AAGGCAGCTTACCGTAGCGTTA	ACACCCAGTAAATCCGGACAAC
Pig9Fw:Pig162Rv	AAGGCAGCTTACCGTAGCGTTA	CCGGCCTACGCTCCCTTTAAAC
Pig9Fw:Pig163Rv	AAGGCAGCTTACCGTAGCGTTA	ACGGCCTACGCTCCCTTTAAAC
Pig9Fw:Pig164Rv	AAGGCAGCTTACCGTAGCGTTA	AAGCCGGCCTACGCTCCCTTTA
Pig9Fw:Pig165Rv	AAGGCAGCTTACCGTAGCGTTA	GCGGCATTTCACAACACGCTTA
Pig9Fw:Pig166Rv	AAGGCAGCTTACCGTAGCGTTA	GCACGGAATTAGCCGGTCCTTA
Pig9Fw:Pig167Rv	AAGGCAGCTTACCGTAGCGTTA	AACGCTCGCATCCTCCGTATTA
Pig9Fw:Pig168Rv	AAGGCAGCTTACCGTAGCGTTA	AACGCTTGCCACCTACGTATTA
Pig9Fw:Pig169Rv	AAGGCAGCTTACCGTAGCGTTA	AACGCTCGCCACCTACGTATTA
Pig9Fw:Pig170Rv	AAGGCAGCTTACCGTAGCGTTA	GATAACGCTCGCATCCTCCGTA
Pig9Fw:Pig171Rv	AAGGCAGCTTACCGTAGCGTTA	GACAACGCTTGCCACCTACGTA
Pig9Fw:Pig172Rv	AAGGCAGCTTACCGTAGCGTTA	TCGGAGTTCTTCGTGATATCTA
Pig9Fw:Pig173Rv	AAGGCAGCTTACCGTAGCGTTA	CTGGTGTTCCTCCTAATATCTA
Pig9Fw:Pig174Rv	AAGGCAGCTTACCGTAGCGTTA	ATATCTACGCATTTCACCGCTA
Pig9Fw:Pig175Rv	AAGGCAGCTTACCGTAGCGTTA	TTCGCCACTGGTGTTCCTCCTA
Pig9Fw:Pig176Rv	AAGGCAGCTTACCGTAGCGTTA	GCTACACCACGAATTCCGCCTA
Pig9Fw:Pig177Rv	AAGGCAGCTTACCGTAGCGTTA	TCCGGACAACGCTTGCCACCTA
Pig9Fw:Pig178Rv	AAGGCAGCTTACCGTAGCGTTA	TACGCATTTCACCGCTACACTA
Pig9Fw:Pig179Rv	AAGGCAGCTTACCGTAGCGTTA	GCAATCGGAGTTCTTCGTGATA
Pig9Fw:Pig180Rv	AAGGCAGCTTACCGTAGCGTTA	GCCACTGGTGTTCCTCCTAATA
Pig9Fw:Pig181Rv	AAGGCAGCTTACCGTAGCGTTA	TACGCTCCCTTTAAACCCAATA
Pig9Fw:Pig182Rv	AAGGCAGCTTACCGTAGCGTTA	GGTTCAGACTTCCGTCCATTGA
Pig9Fw:Pig183Rv	AAGGCAGCTTACCGTAGCGTTA	GGTTCAGACTTACGTCCATTGA
Pig9Fw:Pig184Rv	AAGGCAGCTTACCGTAGCGTTA	TCGCAATCGGAGTTCTTCGTGA
Pig9Fw:Pig185Rv	AAGGCAGCTTACCGTAGCGTTA	GTAAGCTGCCTTCGCAATCGGA
Pig9Fw:Pig186Rv	AAGGCAGCTTACCGTAGCGTTA	GCATTTCACCGCTACACTAGGA
Pig9Fw:Pig187Rv	AAGGCAGCTTACCGTAGCGTTA	CACGCTACTTGGCTGGTTCAGA
Pig9Fw:Pig188Rv	AAGGCAGCTTACCGTAGCGTTA	TGCACGCTACTTGGCTGGTTCA
Pig9Fw:Pig189Rv	AAGGCAGCTTACCGTAGCGTTA	ATACCCGCACTTTCGAGCTTCA
Pig9Fw:Pig190Rv	AAGGCAGCTTACCGTAGCGTTA	GCACTTTCGAGCTTCAGCGTCA
Pig9Fw:Pig191Rv	AAGGCAGCTTACCGTAGCGTTA	TTTACAACCCATAGGGCCGTCA
Pig9Fw:Pig192Rv	AAGGCAGCTTACCGTAGCGTTA	CCTTATTCATGCGGTACCTGCA
Pig9Fw:Pig193Rv	AAGGCAGCTTACCGTAGCGTTA	GCTACGGTAAGCTGCCTTCGCA
Pig9Fw:Pig194Rv	AAGGCAGCTTACCGTAGCGTTA	TGTTCCTCCTAATATCTACGCA
Pig9Fw:Pig195Rv	AAGGCAGCTTACCGTAGCGTTA	GGCTGGTTCAGACTTCCGTCCA
Pig9Fw:Pig196Rv	AAGGCAGCTTACCGTAGCGTTA	GGCTGGTTCAGACTTACGTCCA
Pig9Fw:Pig197Rv	AAGGCAGCTTACCGTAGCGTTA	GCCTACGCTCCCTTTAAACCCA
Pig9Fw:Pig198Rv	AAGGCAGCTTACCGTAGCGTTA	TCAGACTTCCGTCCATTGACCA
Pig9Fw:Pig199Rv	AAGGCAGCTTACCGTAGCGTTA	TCAGACTTACGTCCATTGACCA
Pig9Fw:Pig200Rv	AAGGCAGCTTACCGTAGCGTTA	ATCTATGCATTTCACCGCTACA
Pig9Fw:Pig201Rv	AAGGCAGCTTACCGTAGCGTTA	ATCTAAGCATTTCACCGCTACA
Pig9Fw:Pig202Rv	AAGGCAGCTTACCGTAGCGTTA	AGCCGGCCTACGCTCCCTTTAA
Pig9Fw:Pig203Rv	AAGGCAGCTTACCGTAGCGTTA	CGGCATTTCACAACACGCTTAA
Pig9Fw:Pig204Rv	AAGGCAGCTTACCGTAGCGTTA	CGGAGTTCTTCGTGATATCTAA
Pig9Fw:Pig205Rv	AAGGCAGCTTACCGTAGCGTTA	TCGCCACTGGTGTTCCTCCTAA
Pig9Fw:Pig206Rv	AAGGCAGCTTACCGTAGCGTTA	ACGCTCCCTTTAAACCCAATAA
Pig9Fw:Pig207Rv	AAGGCAGCTTACCGTAGCGTTA	CATTTCACCGCTACACTAGGAA
Pig9Fw:Pig208Rv	AAGGCAGCTTACCGTAGCGTTA	CTTATTCATGCGGTACCTGCAA
Pig9Fw:Pig209Rv	AAGGCAGCTTACCGTAGCGTTA	CTACGGTAAGCTGCCTTCGCAA
Pig9Fw:Pig210Rv	AAGGCAGCTTACCGTAGCGTTA	CCTACGCTCCCTTTAAACCCAA
Pig9Fw:Pig211Rv	AAGGCAGCTTACCGTAGCGTTA	CAGACTTCCGTCCATTGACCAA
Pig9Fw:Pig212Rv	AAGGCAGCTTACCGTAGCGTTA	CAGACTTACGTCCATTGACCAA
Pig9Fw:Pig213Rv	AAGGCAGCTTACCGTAGCGTTA	TACACCCAGTAAATCCGGACAA
Pig9Fw:Pig214Rv	AAGGCAGCTTACCGTAGCGTTA	GCCGGCCTACGCTCCCTTTAAA
Pig9Fw:Pig215Rv	AAGGCAGCTTACCGTAGCGTTA	GGCATTTCACAACACGCTTAAA
Pig9Fw:Pig216Rv	AAGGCAGCTTACCGTAGCGTTA	TTATTCATGCGGTACCTGCAAA
Pig9Fw:Pig217Rv	AAGGCAGCTTACCGTAGCGTTA	GCACGGAGTTAGCCGATGCTTT
Pig9Fw:Pig218Rv	AAGGCAGCTTACCGTAGCGTTA	CCTTCACGCGACTTGGCTGGTT
Pig9Fw:Pig219Rv	AAGGCAGCTTACCGTAGCGTTA	ACGGAGTTAGCCGATGCTTATT
Pig9Fw:Pig220Rv	AAGGCAGCTTACCGTAGCGTTA	CAACGCTCGCCACCTACGTATT
Pig9Fw:Pig221Rv	AAGGCAGCTTACCGTAGCGTTA	TTTCACCGCTACACAACGCATT
Pig9Fw:Pig222Rv	AAGGCAGCTTACCGTAGCGTTA	CTGGTTCAGGCTCTCGCCCATT
Pig9Fw:Pig223Rv	AAGGCAGCTTACCGTAGCGTTA	TTTCACCGCTACACGACGAATT
Pig9Fw:Pig224Rv	AAGGCAGCTTACCGTAGCGTTA	TCCTTCACGCGACTTGGCTGGT
Pig9Fw:Pig225Rv	AAGGCAGCTTACCGTAGCGTTA	ATCGGAGTTCTGCGTCATATCT
Pig9Fw:Pig226Rv	AAGGCAGCTTACCGTAGCGTTA	TCGTCCTGCACGCTACTTGGCT
Pig9Fw:Pig227Rv	AAGGCAGCTTACCGTAGCGTTA	CCCAGTAATTCCGGACAACGCT
Pig9Fw:Pig228Rv	AAGGCAGCTTACCGTAGCGTTA	ATCCGGACAACGCTTGCCACCT
Pig9Fw:Pig229Rv	AAGGCAGCTTACCGTAGCGTTA	CACGGAGTTAGCCGATGCTTAT
Pig9Fw:Pig230Rv	AAGGCAGCTTACCGTAGCGTTA	ACAACGCTCGCCACCTACGTAT
Pig9Fw:Pig231Rv	AAGGCAGCTTACCGTAGCGTTA	CGGAGTTCTGCGTCATATCTAT
Pig9Fw:Pig232Rv	AAGGCAGCTTACCGTAGCGTTA	CAATCGGAGTTCTGCGTCATAT
Pig9Fw:Pig233Rv	AAGGCAGCTTACCGTAGCGTTA	ATTTCACCGCTACACAACGCAT
Pig9Fw:Pig234Rv	AAGGCAGCTTACCGTAGCGTTA	ATTTCACCGCTACACGACGAAT
Pig9Fw:Pig235Rv	AAGGCAGCTTACCGTAGCGTTA	TGGTTCAGGCTCTCGCCCATTG
Pig9Fw:Pig236Rv	AAGGCAGCTTACCGTAGCGTTA	AAAGAGGTTTACAATCCGTAGG
Pig9Fw:Pig237Rv	AAGGCAGCTTACCGTAGCGTTA	CACGCTACTTGGCTGGTTCAGG
Pig9Fw:Pig238Rv	AAGGCAGCTTACCGTAGCGTTA	CACCGCTACACAACGCATTCCG
Pig9Fw:Pig239Rv	AAGGCAGCTTACCGTAGCGTTA	CCCTTTACGCCCAATAATTCCG
Pig9Fw:Pig240Rv	AAGGCAGCTTACCGTAGCGTTA	CACCGCTACACGACGAATTCCG
Pig9Fw:Pig241Rv	AAGGCAGCTTACCGTAGCGTTA	GTCATATCTAAGCATTTCACCG
Pig9Fw:Pig242Rv	AAGGCAGCTTACCGTAGCGTTA	AGCATTTCACCGCTACACGACG
Pig9Fw:Pig243Rv	AAGGCAGCTTACCGTAGCGTTA	CTAAGCATTTCACCGCTACACG
Pig9Fw:Pig244Rv	AAGGCAGCTTACCGTAGCGTTA	CACCCAGTAATTCCGGACAACG
Pig9Fw:Pig245Rv	AAGGCAGCTTACCGTAGCGTTA	TGCATTTCACCGCTACACAACG
Pig9Fw:Pig246Rv	AAGGCAGCTTACCGTAGCGTTA	CAAGCTGCCTTCGCAATCGGAG
Pig9Fw:Pig247Rv	AAGGCAGCTTACCGTAGCGTTA	CTTCACGCGACTTGGCTGGTTC
Pig9Fw:Pig248Rv	AAGGCAGCTTACCGTAGCGTTA	CGGAGTTAGCCGATGCTTATTC
Pig9Fw:Pig249Rv	AAGGCAGCTTACCGTAGCGTTA	TTCACCGCTACACAACGCATTC
Pig9Fw:Pig250Rv	AAGGCAGCTTACCGTAGCGTTA	TTCACCGCTACACGACGAATTC
Pig9Fw:Pig251Rv	AAGGCAGCTTACCGTAGCGTTA	AATCGGAGTTCTGCGTCATATC
Pig9Fw:Pig252Rv	AAGGCAGCTTACCGTAGCGTTA	ACGCTACTTGGCTGGTTCAGGC
Pig9Fw:Pig253Rv	AAGGCAGCTTACCGTAGCGTTA	TCATATCTAAGCATTTCACCGC
Pig9Fw:Pig254Rv	AAGGCAGCTTACCGTAGCGTTA	ACCCAGTAATTCCGGACAACGC
Pig9Fw:Pig255Rv	AAGGCAGCTTACCGTAGCGTTA	GCATTTCACCGCTACACAACGC
Pig9Fw:Pig256Rv	AAGGCAGCTTACCGTAGCGTTA	TCACCGCTACACAACGCATTCC
Pig9Fw:Pig257Rv	AAGGCAGCTTACCGTAGCGTTA	TCACCGCTACACGACGAATTCC
Pig9Fw:Pig258Rv	AAGGCAGCTTACCGTAGCGTTA	GTAAATCCGGACAACGCTTGCC
Pig9Fw:Pig259Rv	AAGGCAGCTTACCGTAGCGTTA	TTCAGGCTCTCGCCCATTGACC
Pig9Fw:Pig260Rv	AAGGCAGCTTACCGTAGCGTTA	GAGGTTTACAATCCGTAGGACC
Pig9Fw:Pig261Rv	AAGGCAGCTTACCGTAGCGTTA	CGTCATATCTAAGCATTTCACC
Pig9Fw:Pig262Rv	AAGGCAGCTTACCGTAGCGTTA	AATCCGGACAACGCTTGCCACC
Pig9Fw:Pig263Rv	AAGGCAGCTTACCGTAGCGTTA	CCGCCTACGCACCCTTTAAACC
Pig9Fw:Pig264Rv	AAGGCAGCTTACCGTAGCGTTA	GTTCAGGCTCTCGCCCATTGAC
Pig9Fw:Pig265Rv	AAGGCAGCTTACCGTAGCGTTA	AGAGGTTTACAATCCGTAGGAC
Pig9Fw:Pig266Rv	AAGGCAGCTTACCGTAGCGTTA	AAGCATTTCACCGCTACACGAC
Pig9Fw:Pig267Rv	AAGGCAGCTTACCGTAGCGTTA	AAATCCGGACAACGCTTGCCAC
Pig9Fw:Pig268Rv	AAGGCAGCTTACCGTAGCGTTA	AATTCCGGACAACGCTCGCCAC
Pig9Fw:Pig269Rv	AAGGCAGCTTACCGTAGCGTTA	ACACCCAGTAATTCCGGACAAC
Pig9Fw:Pig270Rv	AAGGCAGCTTACCGTAGCGTTA	ATGCATTTCACCGCTACACAAC
Pig9Fw:Pig271Rv	AAGGCAGCTTACCGTAGCGTTA	GCACGGAGTTAGCCGATGCTTA
Pig9Fw:Pig272Rv	AAGGCAGCTTACCGTAGCGTTA	GACAACGCTCGCCACCTACGTA
Pig9Fw:Pig273Rv	AAGGCAGCTTACCGTAGCGTTA	TCGGAGTTCTGCGTCATATCTA
Pig9Fw:Pig274Rv	AAGGCAGCTTACCGTAGCGTTA	GCAATCGGAGTTCTGCGTCATA
Pig9Fw:Pig275Rv	AAGGCAGCTTACCGTAGCGTTA	GGTTCAGGCTCTCGCCCATTGA
Pig9Fw:Pig276Rv	AAGGCAGCTTACCGTAGCGTTA	CTTTACGCCCAATAATTCCGGA
Pig9Fw:Pig277Rv	AAGGCAGCTTACCGTAGCGTTA	AAGAGGTTTACAATCCGTAGGA
Pig9Fw:Pig278Rv	AAGGCAGCTTACCGTAGCGTTA	GCATTTCACCGCTACACGACGA
Pig9Fw:Pig279Rv	AAGGCAGCTTACCGTAGCGTTA	TAAGCATTTCACCGCTACACGA
Pig9Fw:Pig280Rv	AAGGCAGCTTACCGTAGCGTTA	CTCACGCGACTTGGCTGGTTCA
Pig9Fw:Pig281Rv	AAGGCAGCTTACCGTAGCGTTA	CATTTCACCGCTACACAACGCA
Pig9Fw:Pig282Rv	AAGGCAGCTTACCGTAGCGTTA	TAAATCCGGACAACGCTTGCCA
Pig9Fw:Pig283Rv	AAGGCAGCTTACCGTAGCGTTA	TAATTCCGGACAACGCTCGCCA
Pig9Fw:Pig284Rv	AAGGCAGCTTACCGTAGCGTTA	TCAGGCTCTCGCCCATTGACCA
Pig9Fw:Pig285Rv	AAGGCAGCTTACCGTAGCGTTA	CTATGCATTTCACCGCTACACA
Pig9Fw:Pig286Rv	AAGGCAGCTTACCGTAGCGTTA	CATTTCACCGCTACACGACGAA
Pig9Fw:Pig287Rv	AAGGCAGCTTACCGTAGCGTTA	CAGGCTCTCGCCCATTGACCAA
Pig9Fw:Pig288Rv	AAGGCAGCTTACCGTAGCGTTA	TACACCCAGTAATTCCGGACAA
Pig9Fw:Pig289Rv	AAGGCAGCTTACCGTAGCGTTA	TATGCATTTCACCGCTACACAA
Pig15Fw:Pig1Rv	AATGGACGTAAGTCTGAACCAG	CCTGCACGCTACTTGGCTGGTT
Pig15Fw:Pig2Rv	AATGGACGTAAGTCTGAACCAG	AGCTGCCTTCGCAATCGGAGTT
Pig15Fw:Pig3Rv	AATGGACGTAAGTCTGAACCAG	TGCCTTCGCAATCGGAGTTCTT
Pig15Fw:Pig4Rv	AATGGACGTAAGTCTGAACCAG	GGCACGGAGTTAGCCGATGCTT
Pig15Fw:Pig5Rv	AATGGACGTAAGTCTGAACCAG	CGCGGCATTTCACAACACGCTT
Pig15Fw:Pig6Rv	AATGGACGTAAGTCTGAACCAG	CCAGTAAATCCGGACAACGCTT
Pig15Fw:Pig7Rv	AATGGACGTAAGTCTGAACCAG	CGATACCCGCACTTTCGAGCTT
Pig15Fw:Pig8Rv	AATGGACGTAAGTCTGAACCAG	GGCACGGAATTAGCCGGTCCTT
Pig15Fw:Pig9Rv	AATGGACGTAAGTCTGAACCAG	TAACGCTACGGTAAGCTGCCTT
Pig15Fw:Pig10Rv	AATGGACGTAAGTCTGAACCAG	GCCGTCATCCTGCACGCTACTT
Pig15Fw:Pig11Rv	AATGGACGTAAGTCTGAACCAG	ACGGAATTAGCCGGTCCTTATT
Pig15Fw:Pig12Rv	AATGGACGTAAGTCTGAACCAG	TAACGCTCGCATCCTCCGTATT
Pig15Fw:Pig13Rv	AATGGACGTAAGTCTGAACCAG	CAACGCTTGCCACCTACGTATT
Pig15Fw:Pig14Rv	AATGGACGTAAGTCTGAACCAG	CTGGTTCAGACTTCCGTCCATT
Pig15Fw:Pig15Rv	AATGGACGTAAGTCTGAACCAG	CTGGTTCAGACTTACGTCCATT
Pig15Fw:Pig16Rv	AATGGACGTAAGTCTGAACCAG	TTTCACCGCTACACTAGGAATT
Pig15Fw:Pig17Rv	AATGGACGTAAGTCTGAACCAG	TCCTGCACGCTACTTGGCTGGT
Pig15Fw:Pig18Rv	AATGGACGTAAGTCTGAACCAG	TGCTGGCACGGAATTAGCCGGT
Pig15Fw:Pig19Rv	AATGGACGTAAGTCTGAACCAG	CCGCACTTTCGAGCTTCAGCGT
Pig15Fw:Pig20Rv	AATGGACGTAAGTCTGAACCAG	CTTGGCTGGTTCAGACTTCCGT
Pig15Fw:Pig21Rv	AATGGACGTAAGTCTGAACCAG	AGTTTACAACCCATAGGGCCGT
Pig15Fw:Pig22Rv	AATGGACGTAAGTCTGAACCAG	CTGCTGGCACGTAGTTAGCCGT
Pig15Fw:Pig23Rv	AATGGACGTAAGTCTGAACCAG	CTTGGCTGGTTCAGACTTACGT
Pig15Fw:Pig24Rv	AATGGACGTAAGTCTGAACCAG	GGACAACGCTTGCCACCTACGT
Pig15Fw:Pig25Rv	AATGGACGTAAGTCTGAACCAG	AAGCTGCCTTCGCAATCGGAGT
Pig15Fw:Pig26Rv	AATGGACGTAAGTCTGAACCAG	CTGCCTTCGCAATCGGAGTTCT
Pig15Fw:Pig27Rv	AATGGACGTAAGTCTGAACCAG	ATCGGAGTTCTTCGTGATATCT
Pig15Fw:Pig28Rv	AATGGACGTAAGTCTGAACCAG	ACTGGTGTTCCTCCTAATATCT
Pig15Fw:Pig29Rv	AATGGACGTAAGTCTGAACCAG	CTTCCGTATTACCGCGGCTGCT
Pig15Fw:Pig30Rv	AATGGACGTAAGTCTGAACCAG	CCTACGTATTACCGCGGCTGCT
Pig15Fw:Pig31Rv	AATGGACGTAAGTCTGAACCAG	TGGCACGGAGTTAGCCGATGCT
Pig15Fw:Pig32Rv	AATGGACGTAAGTCTGAACCAG	TCATCCTGCACGCTACTTGGCT
Pig15Fw:Pig33Rv	AATGGACGTAAGTCTGAACCAG	GACCTTCCGTATTACCGCGGCT
Pig15Fw:Pig34Rv	AATGGACGTAAGTCTGAACCAG	CATCCTCCGTATTACCGCGGCT
Pig15Fw:Pig35Rv	AATGGACGTAAGTCTGAACCAG	CCACCTACGTATTACCGCGGCT
Pig15Fw:Pig36Rv	AATGGACGTAAGTCTGAACCAG	AATATCTACGCATTTCACCGCT
Pig15Fw:Pig37Rv	AATGGACGTAAGTCTGAACCAG	GATATCTAAGCATTTCACCGCT
Pig15Fw:Pig38Rv	AATGGACGTAAGTCTGAACCAG	CATATCTAAGCATTTCACCGCT
Pig15Fw:Pig39Rv	AATGGACGTAAGTCTGAACCAG	CCGCGGCATTTCACAACACGCT
Pig15Fw:Pig40Rv	AATGGACGTAAGTCTGAACCAG	CCCAGTAAATCCGGACAACGCT
Pig15Fw:Pig41Rv	AATGGACGTAAGTCTGAACCAG	TGGCACGGAATTAGCCGGTCCT
Pig15Fw:Pig42Rv	AATGGACGTAAGTCTGAACCAG	CTTCGCCACTGGTGTTCCTCCT
Pig15Fw:Pig43Rv	AATGGACGTAAGTCTGAACCAG	CAACCCATAGGGCCGTCATCCT
Pig15Fw:Pig44Rv	AATGGACGTAAGTCTGAACCAG	CGCTACACCACGAATTCCGCCT
Pig15Fw:Pig45Rv	AATGGACGTAAGTCTGAACCAG	GGTCCTTATTCATGCGGTACCT
Pig15Fw:Pig46Rv	AATGGACGTAAGTCTGAACCAG	ACACCACGAATTCCGCCTACCT
Pig15Fw:Pig47Rv	AATGGACGTAAGTCTGAACCAG	CGCTACTTGGCTGGTTCAGACT
Pig15Fw:Pig48Rv	AATGGACGTAAGTCTGAACCAG	CACGGAATTAGCCGGTCCTTAT
Pig15Fw:Pig49Rv	AATGGACGTAAGTCTGAACCAG	ATAACGCTCGCATCCTCCGTAT
Pig15Fw:Pig50Rv	AATGGACGTAAGTCTGAACCAG	ACAACGCTTGCCACCTACGTAT
Pig15Fw:Pig51Rv	AATGGACGTAAGTCTGAACCAG	CAATCGGAGTTCTTCGTGATAT
Pig15Fw:Pig52Rv	AATGGACGTAAGTCTGAACCAG	CCACTGGTGTTCCTCCTAATAT
Pig15Fw:Pig53Rv	AATGGACGTAAGTCTGAACCAG	CGCAATCGGAGTTCTTCGTGAT
Pig15Fw:Pig54Rv	AATGGACGTAAGTCTGAACCAG	TGCTGGCACGGAGTTAGCCGAT
Pig15Fw:Pig55Rv	AATGGACGTAAGTCTGAACCAG	TTACAACCCATAGGGCCGTCAT
Pig15Fw:Pig56Rv	AATGGACGTAAGTCTGAACCAG	GTTCCTCCTAATATCTACGCAT
Pig15Fw:Pig57Rv	AATGGACGTAAGTCTGAACCAG	GCTGGTTCAGACTTCCGTCCAT
Pig15Fw:Pig58Rv	AATGGACGTAAGTCTGAACCAG	GCTGGTTCAGACTTACGTCCAT
Pig15Fw:Pig59Rv	AATGGACGTAAGTCTGAACCAG	CGCCACTGGTGTTCCTCCTAAT
Pig15Fw:Pig60Rv	AATGGACGTAAGTCTGAACCAG	ATTTCACCGCTACACTAGGAAT
Pig15Fw:Pig61Rv	AATGGACGTAAGTCTGAACCAG	TACGGTAAGCTGCCTTCGCAAT
Pig15Fw:Pig62Rv	AATGGACGTAAGTCTGAACCAG	CTACGCTCCCTTTAAACCCAAT
Pig15Fw:Pig63Rv	AATGGACGTAAGTCTGAACCAG	CAGTAAATCCGGACAACGCTTG
Pig15Fw:Pig64Rv	AATGGACGTAAGTCTGAACCAG	CCGTCATCCTGCACGCTACTTG
Pig15Fw:Pig65Rv	AATGGACGTAAGTCTGAACCAG	TGGTTCAGACTTCCGTCCATTG
Pig15Fw:Pig66Rv	AATGGACGTAAGTCTGAACCAG	TGGTTCAGACTTACGTCCATTG
Pig15Fw:Pig67Rv	AATGGACGTAAGTCTGAACCAG	TGCCTTCGCAATCGGAGTTCTG
Pig15Fw:Pig68Rv	AATGGACGTAAGTCTGAACCAG	TTCCGTATTACCGCGGCTGCTG
Pig15Fw:Pig69Rv	AATGGACGTAAGTCTGAACCAG	CTACGTATTACCGCGGCTGCTG
Pig15Fw:Pig70Rv	AATGGACGTAAGTCTGAACCAG	CATCCTGCACGCTACTTGGCTG
Pig15Fw:Pig71Rv	AATGGACGTAAGTCTGAACCAG	ACCTTCCGTATTACCGCGGCTG
Pig15Fw:Pig72Rv	AATGGACGTAAGTCTGAACCAG	ATCCTCCGTATTACCGCGGCTG
Pig15Fw:Pig73Rv	AATGGACGTAAGTCTGAACCAG	CACCTACGTATTACCGCGGCTG
Pig15Fw:Pig74Rv	AATGGACGTAAGTCTGAACCAG	AACCCATAGGGCCGTCATCCTG
Pig15Fw:Pig75Rv	AATGGACGTAAGTCTGAACCAG	GTCCTTATTCATGCGGTACCTG
Pig15Fw:Pig76Rv	AATGGACGTAAGTCTGAACCAG	AATTAGCCGGTCCTTATTCATG
Pig15Fw:Pig77Rv	AATGGACGTAAGTCTGAACCAG	CGTCATCCTGCACGCTACTTGG
Pig15Fw:Pig78Rv	AATGGACGTAAGTCTGAACCAG	TACGTATTACCGCGGCTGCTGG
Pig15Fw:Pig79Rv	AATGGACGTAAGTCTGAACCAG	ATCCTGCACGCTACTTGGCTGG
Pig15Fw:Pig80Rv	AATGGACGTAAGTCTGAACCAG	AAGCAGTTTACAACCCATAGGG
Pig15Fw:Pig81Rv	AATGGACGTAAGTCTGAACCAG	GGTAAGCTGCCTTCGCAATCGG
Pig15Fw:Pig82Rv	AATGGACGTAAGTCTGAACCAG	TAGCCGGTCCTTATTCATGCGG
Pig15Fw:Pig83Rv	AATGGACGTAAGTCTGAACCAG	TGCCACCTACGTATTACCGCGG
Pig15Fw:Pig84Rv	AATGGACGTAAGTCTGAACCAG	CGCATTTCACCGCTACACTAGG
Pig15Fw:Pig85Rv	AATGGACGTAAGTCTGAACCAG	AAAGCAGTTTACAACCCATAGG
Pig15Fw:Pig86Rv	AATGGACGTAAGTCTGAACCAG	ACGCTACGGTAAGCTGCCTTCG
Pig15Fw:Pig87Rv	AATGGACGTAAGTCTGAACCAG	CGGTAAGCTGCCTTCGCAATCG
Pig15Fw:Pig88Rv	AATGGACGTAAGTCTGAACCAG	TTAGCCGGTCCTTATTCATGCG
Pig15Fw:Pig89Rv	AATGGACGTAAGTCTGAACCAG	TCGCATCCTCCGTATTACCGCG
Pig15Fw:Pig90Rv	AATGGACGTAAGTCTGAACCAG	TTGCCACCTACGTATTACCGCG
Pig15Fw:Pig91Rv	AATGGACGTAAGTCTGAACCAG	TCGCCACCTACGTATTACCGCG
Pig15Fw:Pig92Rv	AATGGACGTAAGTCTGAACCAG	CAGTTTACAACCCATAGGGCCG
Pig15Fw:Pig93Rv	AATGGACGTAAGTCTGAACCAG	GCTCGCATCCTCCGTATTACCG
Pig15Fw:Pig94Rv	AATGGACGTAAGTCTGAACCAG	GCTTGCCACCTACGTATTACCG
Pig15Fw:Pig95Rv	AATGGACGTAAGTCTGAACCAG	GCTCGCCACCTACGTATTACCG
Pig15Fw:Pig96Rv	AATGGACGTAAGTCTGAACCAG	CTAATATCTACGCATTTCACCG
Pig15Fw:Pig97Rv	AATGGACGTAAGTCTGAACCAG	GGTGTTCCTCCTAATATCTACG
Pig15Fw:Pig98Rv	AATGGACGTAAGTCTGAACCAG	CACCCAGTAAATCCGGACAACG
Pig15Fw:Pig99Rv	AATGGACGTAAGTCTGAACCAG	ACGCATTTCACCGCTACACTAG
Pig15Fw:Pig100Rv	AATGGACGTAAGTCTGAACCAG	TAAGCTGCCTTCGCAATCGGAG
Pig15Fw:Pig101Rv	AATGGACGTAAGTCTGAACCAG	GCACGCTACTTGGCTGGTTCAG
Pig15Fw:Pig102Rv	AATGGACGTAAGTCTGAACCAG	TCACGCGACTTGGCTGGTTCAG
Pig15Fw:Pig103Rv	AATGGACGTAAGTCTGAACCAG	TACCCGCACTTTCGAGCTTCAG
Pig15Fw:Pig104Rv	AATGGACGTAAGTCTGAACCAG	GGAGTTCTTCGTGATATCTAAG
Pig15Fw:Pig105Rv	AATGGACGTAAGTCTGAACCAG	CCTCCTAATATCTACGCATTTC
Pig15Fw:Pig106Rv	AATGGACGTAAGTCTGAACCAG	CTGCACGCTACTTGGCTGGTTC
Pig15Fw:Pig107Rv	AATGGACGTAAGTCTGAACCAG	GCTGCCTTCGCAATCGGAGTTC
Pig15Fw:Pig108Rv	AATGGACGTAAGTCTGAACCAG	GATACCCGCACTTTCGAGCTTC
Pig15Fw:Pig109Rv	AATGGACGTAAGTCTGAACCAG	AACGCTACGGTAAGCTGCCTTC
Pig15Fw:Pig110Rv	AATGGACGTAAGTCTGAACCAG	TTCACCGCTACACTAGGAATTC
Pig15Fw:Pig111Rv	AATGGACGTAAGTCTGAACCAG	CGCACTTTCGAGCTTCAGCGTC
Pig15Fw:Pig112Rv	AATGGACGTAAGTCTGAACCAG	TTGGCTGGTTCAGACTTCCGTC
Pig15Fw:Pig113Rv	AATGGACGTAAGTCTGAACCAG	GTTTACAACCCATAGGGCCGTC
Pig15Fw:Pig114Rv	AATGGACGTAAGTCTGAACCAG	TTGGCTGGTTCAGACTTACGTC
Pig15Fw:Pig115Rv	AATGGACGTAAGTCTGAACCAG	CACCACGAATTCCGCCTACCTC
Pig15Fw:Pig116Rv	AATGGACGTAAGTCTGAACCAG	AATCGGAGTTCTTCGTGATATC
Pig15Fw:Pig117Rv	AATGGACGTAAGTCTGAACCAG	CACTGGTGTTCCTCCTAATATC
Pig15Fw:Pig118Rv	AATGGACGTAAGTCTGAACCAG	TACAACCCATAGGGCCGTCATC
Pig15Fw:Pig119Rv	AATGGACGTAAGTCTGAACCAG	ACGGTAAGCTGCCTTCGCAATC
Pig15Fw:Pig120Rv	AATGGACGTAAGTCTGAACCAG	AGTAAATCCGGACAACGCTTGC
Pig15Fw:Pig121Rv	AATGGACGTAAGTCTGAACCAG	GCCTTCGCAATCGGAGTTCTGC
Pig15Fw:Pig122Rv	AATGGACGTAAGTCTGAACCAG	ACCTACGTATTACCGCGGCTGC
Pig15Fw:Pig123Rv	AATGGACGTAAGTCTGAACCAG	TCCTTATTCATGCGGTACCTGC
Pig15Fw:Pig124Rv	AATGGACGTAAGTCTGAACCAG	ATTAGCCGGTCCTTATTCATGC
Pig15Fw:Pig125Rv	AATGGACGTAAGTCTGAACCAG	GTCATCCTGCACGCTACTTGGC
Pig15Fw:Pig126Rv	AATGGACGTAAGTCTGAACCAG	AGCAGTTTACAACCCATAGGGC
Pig15Fw:Pig127Rv	AATGGACGTAAGTCTGAACCAG	CTCGCATCCTCCGTATTACCGC
Pig15Fw:Pig128Rv	AATGGACGTAAGTCTGAACCAG	CTTGCCACCTACGTATTACCGC
Pig15Fw:Pig129Rv	AATGGACGTAAGTCTGAACCAG	CTCGCCACCTACGTATTACCGC
Pig15Fw:Pig130Rv	AATGGACGTAAGTCTGAACCAG	TAATATCTACGCATTTCACCGC
Pig15Fw:Pig131Rv	AATGGACGTAAGTCTGAACCAG	TGATATCTAAGCATTTCACCGC
Pig15Fw:Pig132Rv	AATGGACGTAAGTCTGAACCAG	GTGTTCCTCCTAATATCTACGC
Pig15Fw:Pig133Rv	AATGGACGTAAGTCTGAACCAG	ACCCAGTAAATCCGGACAACGC
Pig15Fw:Pig134Rv	AATGGACGTAAGTCTGAACCAG	ACCCGCACTTTCGAGCTTCAGC
Pig15Fw:Pig135Rv	AATGGACGTAAGTCTGAACCAG	GAGTTCTTCGTGATATCTAAGC
Pig15Fw:Pig136Rv	AATGGACGTAAGTCTGAACCAG	TGGCTGGTTCAGACTTCCGTCC
Pig15Fw:Pig137Rv	AATGGACGTAAGTCTGAACCAG	TGGCTGGTTCAGACTTACGTCC
Pig15Fw:Pig138Rv	AATGGACGTAAGTCTGAACCAG	ACCACGAATTCCGCCTACCTCC
Pig15Fw:Pig139Rv	AATGGACGTAAGTCTGAACCAG	ACAACCCATAGGGCCGTCATCC
Pig15Fw:Pig140Rv	AATGGACGTAAGTCTGAACCAG	GCAGTTTACAACCCATAGGGCC
Pig15Fw:Pig141Rv	AATGGACGTAAGTCTGAACCAG	GGCCTACGCTCCCTTTAAACCC
Pig15Fw:Pig142Rv	AATGGACGTAAGTCTGAACCAG	CGCTCGCATCCTCCGTATTACC
Pig15Fw:Pig143Rv	AATGGACGTAAGTCTGAACCAG	CGCTTGCCACCTACGTATTACC
Pig15Fw:Pig144Rv	AATGGACGTAAGTCTGAACCAG	CGCTCGCCACCTACGTATTACC
Pig15Fw:Pig145Rv	AATGGACGTAAGTCTGAACCAG	TACACCACGAATTCCGCCTACC
Pig15Fw:Pig146Rv	AATGGACGTAAGTCTGAACCAG	TTCAGACTTCCGTCCATTGACC
Pig15Fw:Pig147Rv	AATGGACGTAAGTCTGAACCAG	TTCAGACTTACGTCCATTGACC
Pig15Fw:Pig148Rv	AATGGACGTAAGTCTGAACCAG	CCTAATATCTACGCATTTCACC
Pig15Fw:Pig149Rv	AATGGACGTAAGTCTGAACCAG	CGGCCTACGCTCCCTTTAAACC
Pig15Fw:Pig150Rv	AATGGACGTAAGTCTGAACCAG	ACGCTCGCATCCTCCGTATTAC
Pig15Fw:Pig151Rv	AATGGACGTAAGTCTGAACCAG	ACGCTTGCCACCTACGTATTAC
Pig15Fw:Pig152Rv	AATGGACGTAAGTCTGAACCAG	ACGCTCGCCACCTACGTATTAC
Pig15Fw:Pig153Rv	AATGGACGTAAGTCTGAACCAG	TGGTGTTCCTCCTAATATCTAC
Pig15Fw:Pig154Rv	AATGGACGTAAGTCTGAACCAG	TATCTATGCATTTCACCGCTAC
Pig15Fw:Pig155Rv	AATGGACGTAAGTCTGAACCAG	TATCTAAGCATTTCACCGCTAC
Pig15Fw:Pig156Rv	AATGGACGTAAGTCTGAACCAG	GTTCAGACTTCCGTCCATTGAC
Pig15Fw:Pig157Rv	AATGGACGTAAGTCTGAACCAG	GTTCAGACTTACGTCCATTGAC
Pig15Fw:Pig158Rv	AATGGACGTAAGTCTGAACCAG	ACGCTACTTGGCTGGTTCAGAC
Pig15Fw:Pig159Rv	AATGGACGTAAGTCTGAACCAG	TCTATGCATTTCACCGCTACAC
Pig15Fw:Pig160Rv	AATGGACGTAAGTCTGAACCAG	TCTAAGCATTTCACCGCTACAC
Pig15Fw:Pig161Rv	AATGGACGTAAGTCTGAACCAG	ACACCCAGTAAATCCGGACAAC
Pig15Fw:Pig162Rv	AATGGACGTAAGTCTGAACCAG	CCGGCCTACGCTCCCTTTAAAC
Pig15Fw:Pig163Rv	AATGGACGTAAGTCTGAACCAG	ACGGCCTACGCTCCCTTTAAAC
Pig15Fw:Pig164Rv	AATGGACGTAAGTCTGAACCAG	AAGCCGGCCTACGCTCCCTTTA
Pig15Fw:Pig165Rv	AATGGACGTAAGTCTGAACCAG	GCGGCATTTCACAACACGCTTA
Pig15Fw:Pig166Rv	AATGGACGTAAGTCTGAACCAG	GCACGGAATTAGCCGGTCCTTA
Pig15Fw:Pig167Rv	AATGGACGTAAGTCTGAACCAG	AACGCTCGCATCCTCCGTATTA
Pig15Fw:Pig168Rv	AATGGACGTAAGTCTGAACCAG	AACGCTTGCCACCTACGTATTA
Pig15Fw:Pig169Rv	AATGGACGTAAGTCTGAACCAG	AACGCTCGCCACCTACGTATTA
Pig15Fw:Pig170Rv	AATGGACGTAAGTCTGAACCAG	GATAACGCTCGCATCCTCCGTA
Pig15Fw:Pig171Rv	AATGGACGTAAGTCTGAACCAG	GACAACGCTTGCCACCTACGTA
Pig15Fw:Pig172Rv	AATGGACGTAAGTCTGAACCAG	TCGGAGTTCTTCGTGATATCTA
Pig15Fw:Pig173Rv	AATGGACGTAAGTCTGAACCAG	CTGGTGTTCCTCCTAATATCTA
Pig15Fw:Pig174Rv	AATGGACGTAAGTCTGAACCAG	ATATCTACGCATTTCACCGCTA
Pig15Fw:Pig175Rv	AATGGACGTAAGTCTGAACCAG	TTCGCCACTGGTGTTCCTCCTA
Pig15Fw:Pig176Rv	AATGGACGTAAGTCTGAACCAG	GCTACACCACGAATTCCGCCTA
Pig15Fw:Pig177Rv	AATGGACGTAAGTCTGAACCAG	TCCGGACAACGCTTGCCACCTA
Pig15Fw:Pig178Rv	AATGGACGTAAGTCTGAACCAG	TACGCATTTCACCGCTACACTA
Pig15Fw:Pig179Rv	AATGGACGTAAGTCTGAACCAG	GCAATCGGAGTTCTTCGTGATA
Pig15Fw:Pig180Rv	AATGGACGTAAGTCTGAACCAG	GCCACTGGTGTTCCTCCTAATA
Pig15Fw:Pig181Rv	AATGGACGTAAGTCTGAACCAG	TACGCTCCCTTTAAACCCAATA
Pig15Fw:Pig182Rv	AATGGACGTAAGTCTGAACCAG	GGTTCAGACTTCCGTCCATTGA
Pig15Fw:Pig183Rv	AATGGACGTAAGTCTGAACCAG	GGTTCAGACTTACGTCCATTGA
Pig15Fw:Pig184Rv	AATGGACGTAAGTCTGAACCAG	TCGCAATCGGAGTTCTTCGTGA
Pig15Fw:Pig185Rv	AATGGACGTAAGTCTGAACCAG	GTAAGCTGCCTTCGCAATCGGA
Pig15Fw:Pig186Rv	AATGGACGTAAGTCTGAACCAG	GCATTTCACCGCTACACTAGGA
Pig15Fw:Pig187Rv	AATGGACGTAAGTCTGAACCAG	CACGCTACTTGGCTGGTTCAGA
Pig15Fw:Pig188Rv	AATGGACGTAAGTCTGAACCAG	TGCACGCTACTTGGCTGGTTCA
Pig15Fw:Pig189Rv	AATGGACGTAAGTCTGAACCAG	ATACCCGCACTTTCGAGCTTCA
Pig15Fw:Pig190Rv	AATGGACGTAAGTCTGAACCAG	GCACTTTCGAGCTTCAGCGTCA
Pig15Fw:Pig191Rv	AATGGACGTAAGTCTGAACCAG	TTTACAACCCATAGGGCCGTCA
Pig15Fw:Pig192Rv	AATGGACGTAAGTCTGAACCAG	CCTTATTCATGCGGTACCTGCA
Pig15Fw:Pig193Rv	AATGGACGTAAGTCTGAACCAG	GCTACGGTAAGCTGCCTTCGCA
Pig15Fw:Pig194Rv	AATGGACGTAAGTCTGAACCAG	TGTTCCTCCTAATATCTACGCA
Pig15Fw:Pig195Rv	AATGGACGTAAGTCTGAACCAG	GGCTGGTTCAGACTTCCGTCCA
Pig15Fw:Pig196Rv	AATGGACGTAAGTCTGAACCAG	GGCTGGTTCAGACTTACGTCCA
Pig15Fw:Pig197Rv	AATGGACGTAAGTCTGAACCAG	GCCTACGCTCCCTTTAAACCCA
Pig15Fw:Pig198Rv	AATGGACGTAAGTCTGAACCAG	TCAGACTTCCGTCCATTGACCA
Pig15Fw:Pig199Rv	AATGGACGTAAGTCTGAACCAG	TCAGACTTACGTCCATTGACCA
Pig15Fw:Pig200Rv	AATGGACGTAAGTCTGAACCAG	ATCTATGCATTTCACCGCTACA
Pig15Fw:Pig201Rv	AATGGACGTAAGTCTGAACCAG	ATCTAAGCATTTCACCGCTACA
Pig15Fw:Pig202Rv	AATGGACGTAAGTCTGAACCAG	AGCCGGCCTACGCTCCCTTTAA
Pig15Fw:Pig203Rv	AATGGACGTAAGTCTGAACCAG	CGGCATTTCACAACACGCTTAA
Pig15Fw:Pig204Rv	AATGGACGTAAGTCTGAACCAG	CGGAGTTCTTCGTGATATCTAA
Pig15Fw:Pig205Rv	AATGGACGTAAGTCTGAACCAG	TCGCCACTGGTGTTCCTCCTAA
Pig15Fw:Pig206Rv	AATGGACGTAAGTCTGAACCAG	ACGCTCCCTTTAAACCCAATAA
Pig15Fw:Pig207Rv	AATGGACGTAAGTCTGAACCAG	CATTTCACCGCTACACTAGGAA
Pig15Fw:Pig208Rv	AATGGACGTAAGTCTGAACCAG	CTTATTCATGCGGTACCTGCAA
Pig15Fw:Pig209Rv	AATGGACGTAAGTCTGAACCAG	CTACGGTAAGCTGCCTTCGCAA
Pig15Fw:Pig210Rv	AATGGACGTAAGTCTGAACCAG	CCTACGCTCCCTTTAAACCCAA
Pig15Fw:Pig211Rv	AATGGACGTAAGTCTGAACCAG	CAGACTTCCGTCCATTGACCAA
Pig15Fw:Pig212Rv	AATGGACGTAAGTCTGAACCAG	CAGACTTACGTCCATTGACCAA
Pig15Fw:Pig213Rv	AATGGACGTAAGTCTGAACCAG	TACACCCAGTAAATCCGGACAA
Pig15Fw:Pig214Rv	AATGGACGTAAGTCTGAACCAG	GCCGGCCTACGCTCCCTTTAAA
Pig15Fw:Pig215Rv	AATGGACGTAAGTCTGAACCAG	GGCATTTCACAACACGCTTAAA
Pig15Fw:Pig216Rv	AATGGACGTAAGTCTGAACCAG	TTATTCATGCGGTACCTGCAAA
Pig15Fw:Pig217Rv	AATGGACGTAAGTCTGAACCAG	GCACGGAGTTAGCCGATGCTTT
Pig15Fw:Pig218Rv	AATGGACGTAAGTCTGAACCAG	CCTTCACGCGACTTGGCTGGTT
Pig15Fw:Pig219Rv	AATGGACGTAAGTCTGAACCAG	ACGGAGTTAGCCGATGCTTATT
Pig15Fw:Pig220Rv	AATGGACGTAAGTCTGAACCAG	CAACGCTCGCCACCTACGTATT
Pig15Fw:Pig221Rv	AATGGACGTAAGTCTGAACCAG	TTTCACCGCTACACAACGCATT
Pig15Fw:Pig222Rv	AATGGACGTAAGTCTGAACCAG	CTGGTTCAGGCTCTCGCCCATT
Pig15Fw:Pig223Rv	AATGGACGTAAGTCTGAACCAG	TTTCACCGCTACACGACGAATT
Pig15Fw:Pig224Rv	AATGGACGTAAGTCTGAACCAG	TCCTTCACGCGACTTGGCTGGT
Pig15Fw:Pig225Rv	AATGGACGTAAGTCTGAACCAG	ATCGGAGTTCTGCGTCATATCT
Pig15Fw:Pig226Rv	AATGGACGTAAGTCTGAACCAG	TCGTCCTGCACGCTACTTGGCT
Pig15Fw:Pig227Rv	AATGGACGTAAGTCTGAACCAG	CCCAGTAATTCCGGACAACGCT
Pig15Fw:Pig228Rv	AATGGACGTAAGTCTGAACCAG	ATCCGGACAACGCTTGCCACCT
Pig15Fw:Pig229Rv	AATGGACGTAAGTCTGAACCAG	CACGGAGTTAGCCGATGCTTAT
Pig15Fw:Pig230Rv	AATGGACGTAAGTCTGAACCAG	ACAACGCTCGCCACCTACGTAT
Pig15Fw:Pig231Rv	AATGGACGTAAGTCTGAACCAG	CGGAGTTCTGCGTCATATCTAT
Pig15Fw:Pig232Rv	AATGGACGTAAGTCTGAACCAG	CAATCGGAGTTCTGCGTCATAT
Pig15Fw:Pig233Rv	AATGGACGTAAGTCTGAACCAG	ATTTCACCGCTACACAACGCAT
Pig15Fw:Pig234Rv	AATGGACGTAAGTCTGAACCAG	ATTTCACCGCTACACGACGAAT
Pig15Fw:Pig235Rv	AATGGACGTAAGTCTGAACCAG	TGGTTCAGGCTCTCGCCCATTG
Pig15Fw:Pig236Rv	AATGGACGTAAGTCTGAACCAG	AAAGAGGTTTACAATCCGTAGG
Pig15Fw:Pig237Rv	AATGGACGTAAGTCTGAACCAG	CACGCTACTTGGCTGGTTCAGG
Pig15Fw:Pig238Rv	AATGGACGTAAGTCTGAACCAG	CACCGCTACACAACGCATTCCG
Pig15Fw:Pig239Rv	AATGGACGTAAGTCTGAACCAG	CCCTTTACGCCCAATAATTCCG
Pig15Fw:Pig240Rv	AATGGACGTAAGTCTGAACCAG	CACCGCTACACGACGAATTCCG
Pig15Fw:Pig241Rv	AATGGACGTAAGTCTGAACCAG	GTCATATCTAAGCATTTCACCG
Pig15Fw:Pig242Rv	AATGGACGTAAGTCTGAACCAG	AGCATTTCACCGCTACACGACG
Pig15Fw:Pig243Rv	AATGGACGTAAGTCTGAACCAG	CTAAGCATTTCACCGCTACACG
Pig15Fw:Pig244Rv	AATGGACGTAAGTCTGAACCAG	CACCCAGTAATTCCGGACAACG
Pig15Fw:Pig245Rv	AATGGACGTAAGTCTGAACCAG	TGCATTTCACCGCTACACAACG
Pig15Fw:Pig246Rv	AATGGACGTAAGTCTGAACCAG	CAAGCTGCCTTCGCAATCGGAG
Pig15Fw:Pig247Rv	AATGGACGTAAGTCTGAACCAG	CTTCACGCGACTTGGCTGGTTC
Pig15Fw:Pig248Rv	AATGGACGTAAGTCTGAACCAG	CGGAGTTAGCCGATGCTTATTC
Pig15Fw:Pig249Rv	AATGGACGTAAGTCTGAACCAG	TTCACCGCTACACAACGCATTC
Pig15Fw:Pig250Rv	AATGGACGTAAGTCTGAACCAG	TTCACCGCTACACGACGAATTC
Pig15Fw:Pig251Rv	AATGGACGTAAGTCTGAACCAG	AATCGGAGTTCTGCGTCATATC
Pig15Fw:Pig252Rv	AATGGACGTAAGTCTGAACCAG	ACGCTACTTGGCTGGTTCAGGC
Pig15Fw:Pig253Rv	AATGGACGTAAGTCTGAACCAG	TCATATCTAAGCATTTCACCGC
Pig15Fw:Pig254Rv	AATGGACGTAAGTCTGAACCAG	ACCCAGTAATTCCGGACAACGC
Pig15Fw:Pig255Rv	AATGGACGTAAGTCTGAACCAG	GCATTTCACCGCTACACAACGC
Pig15Fw:Pig256Rv	AATGGACGTAAGTCTGAACCAG	TCACCGCTACACAACGCATTCC
Pig15Fw:Pig257Rv	AATGGACGTAAGTCTGAACCAG	TCACCGCTACACGACGAATTCC
Pig15Fw:Pig258Rv	AATGGACGTAAGTCTGAACCAG	GTAAATCCGGACAACGCTTGCC
Pig15Fw:Pig259Rv	AATGGACGTAAGTCTGAACCAG	TTCAGGCTCTCGCCCATTGACC
Pig15Fw:Pig260Rv	AATGGACGTAAGTCTGAACCAG	GAGGTTTACAATCCGTAGGACC
Pig15Fw:Pig261Rv	AATGGACGTAAGTCTGAACCAG	CGTCATATCTAAGCATTTCACC
Pig15Fw:Pig262Rv	AATGGACGTAAGTCTGAACCAG	AATCCGGACAACGCTTGCCACC
Pig15Fw:Pig263Rv	AATGGACGTAAGTCTGAACCAG	CCGCCTACGCACCCTTTAAACC
Pig15Fw:Pig264Rv	AATGGACGTAAGTCTGAACCAG	GTTCAGGCTCTCGCCCATTGAC
Pig15Fw:Pig265Rv	AATGGACGTAAGTCTGAACCAG	AGAGGTTTACAATCCGTAGGAC
Pig15Fw:Pig266Rv	AATGGACGTAAGTCTGAACCAG	AAGCATTTCACCGCTACACGAC
Pig15Fw:Pig267Rv	AATGGACGTAAGTCTGAACCAG	AAATCCGGACAACGCTTGCCAC
Pig15Fw:Pig268Rv	AATGGACGTAAGTCTGAACCAG	AATTCCGGACAACGCTCGCCAC
Pig15Fw:Pig269Rv	AATGGACGTAAGTCTGAACCAG	ACACCCAGTAATTCCGGACAAC
Pig15Fw:Pig270Rv	AATGGACGTAAGTCTGAACCAG	ATGCATTTCACCGCTACACAAC
Pig15Fw:Pig271Rv	AATGGACGTAAGTCTGAACCAG	GCACGGAGTTAGCCGATGCTTA
Pig15Fw:Pig272Rv	AATGGACGTAAGTCTGAACCAG	GACAACGCTCGCCACCTACGTA
Pig15Fw:Pig273Rv	AATGGACGTAAGTCTGAACCAG	TCGGAGTTCTGCGTCATATCTA
Pig15Fw:Pig274Rv	AATGGACGTAAGTCTGAACCAG	GCAATCGGAGTTCTGCGTCATA
Pig15Fw:Pig275Rv	AATGGACGTAAGTCTGAACCAG	GGTTCAGGCTCTCGCCCATTGA
Pig15Fw:Pig276Rv	AATGGACGTAAGTCTGAACCAG	CTTTACGCCCAATAATTCCGGA
Pig15Fw:Pig277Rv	AATGGACGTAAGTCTGAACCAG	AAGAGGTTTACAATCCGTAGGA
Pig15Fw:Pig278Rv	AATGGACGTAAGTCTGAACCAG	GCATTTCACCGCTACACGACGA
Pig15Fw:Pig279Rv	AATGGACGTAAGTCTGAACCAG	TAAGCATTTCACCGCTACACGA
Pig15Fw:Pig280Rv	AATGGACGTAAGTCTGAACCAG	CTCACGCGACTTGGCTGGTTCA
Pig15Fw:Pig281Rv	AATGGACGTAAGTCTGAACCAG	CATTTCACCGCTACACAACGCA
Pig15Fw:Pig282Rv	AATGGACGTAAGTCTGAACCAG	TAAATCCGGACAACGCTTGCCA
Pig15Fw:Pig283Rv	AATGGACGTAAGTCTGAACCAG	TAATTCCGGACAACGCTCGCCA
Pig15Fw:Pig284Rv	AATGGACGTAAGTCTGAACCAG	TCAGGCTCTCGCCCATTGACCA
Pig15Fw:Pig285Rv	AATGGACGTAAGTCTGAACCAG	CTATGCATTTCACCGCTACACA
Pig15Fw:Pig286Rv	AATGGACGTAAGTCTGAACCAG	CATTTCACCGCTACACGACGAA
Pig15Fw:Pig287Rv	AATGGACGTAAGTCTGAACCAG	CAGGCTCTCGCCCATTGACCAA
Pig15Fw:Pig288Rv	AATGGACGTAAGTCTGAACCAG	TACACCCAGTAATTCCGGACAA
Pig15Fw:Pig289Rv	AATGGACGTAAGTCTGAACCAG	TATGCATTTCACCGCTACACAA
Pig19Fw:Pig1Rv	ACGCTGAAGCTCGAAAGTGCGG	CCTGCACGCTACTTGGCTGGTT
Pig19Fw:Pig2Rv	ACGCTGAAGCTCGAAAGTGCGG	AGCTGCCTTCGCAATCGGAGTT
Pig19Fw:Pig3Rv	ACGCTGAAGCTCGAAAGTGCGG	TGCCTTCGCAATCGGAGTTCTT
Pig19Fw:Pig4Rv	ACGCTGAAGCTCGAAAGTGCGG	GGCACGGAGTTAGCCGATGCTT
Pig19Fw:Pig5Rv	ACGCTGAAGCTCGAAAGTGCGG	CGCGGCATTTCACAACACGCTT
Pig19Fw:Pig6Rv	ACGCTGAAGCTCGAAAGTGCGG	CCAGTAAATCCGGACAACGCTT
Pig19Fw:Pig7Rv	ACGCTGAAGCTCGAAAGTGCGG	CGATACCCGCACTTTCGAGCTT
Pig19Fw:Pig8Rv	ACGCTGAAGCTCGAAAGTGCGG	GGCACGGAATTAGCCGGTCCTT
Pig19Fw:Pig9Rv	ACGCTGAAGCTCGAAAGTGCGG	TAACGCTACGGTAAGCTGCCTT
Pig19Fw:Pig10Rv	ACGCTGAAGCTCGAAAGTGCGG	GCCGTCATCCTGCACGCTACTT
Pig19Fw:Pig11Rv	ACGCTGAAGCTCGAAAGTGCGG	ACGGAATTAGCCGGTCCTTATT
Pig19Fw:Pig12Rv	ACGCTGAAGCTCGAAAGTGCGG	TAACGCTCGCATCCTCCGTATT
Pig19Fw:Pig13Rv	ACGCTGAAGCTCGAAAGTGCGG	CAACGCTTGCCACCTACGTATT
Pig19Fw:Pig14Rv	ACGCTGAAGCTCGAAAGTGCGG	CTGGTTCAGACTTCCGTCCATT
Pig19Fw:Pig15Rv	ACGCTGAAGCTCGAAAGTGCGG	CTGGTTCAGACTTACGTCCATT
Pig19Fw:Pig16Rv	ACGCTGAAGCTCGAAAGTGCGG	TTTCACCGCTACACTAGGAATT
Pig19Fw:Pig17Rv	ACGCTGAAGCTCGAAAGTGCGG	TCCTGCACGCTACTTGGCTGGT
Pig19Fw:Pig18Rv	ACGCTGAAGCTCGAAAGTGCGG	TGCTGGCACGGAATTAGCCGGT
Pig19Fw:Pig19Rv	ACGCTGAAGCTCGAAAGTGCGG	CCGCACTTTCGAGCTTCAGCGT
Pig19Fw:Pig20Rv	ACGCTGAAGCTCGAAAGTGCGG	CTTGGCTGGTTCAGACTTCCGT
Pig19Fw:Pig21Rv	ACGCTGAAGCTCGAAAGTGCGG	AGTTTACAACCCATAGGGCCGT
Pig19Fw:Pig22Rv	ACGCTGAAGCTCGAAAGTGCGG	CTGCTGGCACGTAGTTAGCCGT
Pig19Fw:Pig23Rv	ACGCTGAAGCTCGAAAGTGCGG	CTTGGCTGGTTCAGACTTACGT
Pig19Fw:Pig24Rv	ACGCTGAAGCTCGAAAGTGCGG	GGACAACGCTTGCCACCTACGT
Pig19Fw:Pig25Rv	ACGCTGAAGCTCGAAAGTGCGG	AAGCTGCCTTCGCAATCGGAGT
Pig19Fw:Pig26Rv	ACGCTGAAGCTCGAAAGTGCGG	CTGCCTTCGCAATCGGAGTTCT
Pig19Fw:Pig27Rv	ACGCTGAAGCTCGAAAGTGCGG	ATCGGAGTTCTTCGTGATATCT
Pig19Fw:Pig28Rv	ACGCTGAAGCTCGAAAGTGCGG	ACTGGTGTTCCTCCTAATATCT
Pig19Fw:Pig29Rv	ACGCTGAAGCTCGAAAGTGCGG	CTTCCGTATTACCGCGGCTGCT
Pig19Fw:Pig30Rv	ACGCTGAAGCTCGAAAGTGCGG	CCTACGTATTACCGCGGCTGCT
Pig19Fw:Pig31Rv	ACGCTGAAGCTCGAAAGTGCGG	TGGCACGGAGTTAGCCGATGCT
Pig19Fw:Pig32Rv	ACGCTGAAGCTCGAAAGTGCGG	TCATCCTGCACGCTACTTGGCT
Pig19Fw:Pig33Rv	ACGCTGAAGCTCGAAAGTGCGG	GACCTTCCGTATTACCGCGGCT
Pig19Fw:Pig34Rv	ACGCTGAAGCTCGAAAGTGCGG	CATCCTCCGTATTACCGCGGCT
Pig19Fw:Pig35Rv	ACGCTGAAGCTCGAAAGTGCGG	CCACCTACGTATTACCGCGGCT
Pig19Fw:Pig36Rv	ACGCTGAAGCTCGAAAGTGCGG	AATATCTACGCATTTCACCGCT
Pig19Fw:Pig37Rv	ACGCTGAAGCTCGAAAGTGCGG	GATATCTAAGCATTTCACCGCT
Pig19Fw:Pig38Rv	ACGCTGAAGCTCGAAAGTGCGG	CATATCTAAGCATTTCACCGCT
Pig19Fw:Pig39Rv	ACGCTGAAGCTCGAAAGTGCGG	CCGCGGCATTTCACAACACGCT
Pig19Fw:Pig40Rv	ACGCTGAAGCTCGAAAGTGCGG	CCCAGTAAATCCGGACAACGCT
Pig19Fw:Pig41Rv	ACGCTGAAGCTCGAAAGTGCGG	TGGCACGGAATTAGCCGGTCCT
Pig19Fw:Pig42Rv	ACGCTGAAGCTCGAAAGTGCGG	CTTCGCCACTGGTGTTCCTCCT
Pig19Fw:Pig43Rv	ACGCTGAAGCTCGAAAGTGCGG	CAACCCATAGGGCCGTCATCCT
Pig19Fw:Pig44Rv	ACGCTGAAGCTCGAAAGTGCGG	CGCTACACCACGAATTCCGCCT
Pig19Fw:Pig45Rv	ACGCTGAAGCTCGAAAGTGCGG	GGTCCTTATTCATGCGGTACCT
Pig19Fw:Pig46Rv	ACGCTGAAGCTCGAAAGTGCGG	ACACCACGAATTCCGCCTACCT
Pig19Fw:Pig47Rv	ACGCTGAAGCTCGAAAGTGCGG	CGCTACTTGGCTGGTTCAGACT
Pig19Fw:Pig48Rv	ACGCTGAAGCTCGAAAGTGCGG	CACGGAATTAGCCGGTCCTTAT
Pig19Fw:Pig49Rv	ACGCTGAAGCTCGAAAGTGCGG	ATAACGCTCGCATCCTCCGTAT
Pig19Fw:Pig50Rv	ACGCTGAAGCTCGAAAGTGCGG	ACAACGCTTGCCACCTACGTAT
Pig19Fw:Pig51Rv	ACGCTGAAGCTCGAAAGTGCGG	CAATCGGAGTTCTTCGTGATAT
Pig19Fw:Pig52Rv	ACGCTGAAGCTCGAAAGTGCGG	CCACTGGTGTTCCTCCTAATAT
Pig19Fw:Pig53Rv	ACGCTGAAGCTCGAAAGTGCGG	CGCAATCGGAGTTCTTCGTGAT
Pig19Fw:Pig54Rv	ACGCTGAAGCTCGAAAGTGCGG	TGCTGGCACGGAGTTAGCCGAT
Pig19Fw:Pig55Rv	ACGCTGAAGCTCGAAAGTGCGG	TTACAACCCATAGGGCCGTCAT
Pig19Fw:Pig56Rv	ACGCTGAAGCTCGAAAGTGCGG	GTTCCTCCTAATATCTACGCAT
Pig19Fw:Pig57Rv	ACGCTGAAGCTCGAAAGTGCGG	GCTGGTTCAGACTTCCGTCCAT
Pig19Fw:Pig58Rv	ACGCTGAAGCTCGAAAGTGCGG	GCTGGTTCAGACTTACGTCCAT
Pig19Fw:Pig59Rv	ACGCTGAAGCTCGAAAGTGCGG	CGCCACTGGTGTTCCTCCTAAT
Pig19Fw:Pig60Rv	ACGCTGAAGCTCGAAAGTGCGG	ATTTCACCGCTACACTAGGAAT
Pig19Fw:Pig61Rv	ACGCTGAAGCTCGAAAGTGCGG	TACGGTAAGCTGCCTTCGCAAT
Pig19Fw:Pig62Rv	ACGCTGAAGCTCGAAAGTGCGG	CTACGCTCCCTTTAAACCCAAT
Pig19Fw:Pig63Rv	ACGCTGAAGCTCGAAAGTGCGG	CAGTAAATCCGGACAACGCTTG
Pig19Fw:Pig64Rv	ACGCTGAAGCTCGAAAGTGCGG	CCGTCATCCTGCACGCTACTTG
Pig19Fw:Pig65Rv	ACGCTGAAGCTCGAAAGTGCGG	TGGTTCAGACTTCCGTCCATTG
Pig19Fw:Pig66Rv	ACGCTGAAGCTCGAAAGTGCGG	TGGTTCAGACTTACGTCCATTG
Pig19Fw:Pig67Rv	ACGCTGAAGCTCGAAAGTGCGG	TGCCTTCGCAATCGGAGTTCTG
Pig19Fw:Pig68Rv	ACGCTGAAGCTCGAAAGTGCGG	TTCCGTATTACCGCGGCTGCTG
Pig19Fw:Pig69Rv	ACGCTGAAGCTCGAAAGTGCGG	CTACGTATTACCGCGGCTGCTG
Pig19Fw:Pig70Rv	ACGCTGAAGCTCGAAAGTGCGG	CATCCTGCACGCTACTTGGCTG
Pig19Fw:Pig71Rv	ACGCTGAAGCTCGAAAGTGCGG	ACCTTCCGTATTACCGCGGCTG
Pig19Fw:Pig72Rv	ACGCTGAAGCTCGAAAGTGCGG	ATCCTCCGTATTACCGCGGCTG
Pig19Fw:Pig73Rv	ACGCTGAAGCTCGAAAGTGCGG	CACCTACGTATTACCGCGGCTG
Pig19Fw:Pig74Rv	ACGCTGAAGCTCGAAAGTGCGG	AACCCATAGGGCCGTCATCCTG
Pig19Fw:Pig75Rv	ACGCTGAAGCTCGAAAGTGCGG	GTCCTTATTCATGCGGTACCTG
Pig19Fw:Pig76Rv	ACGCTGAAGCTCGAAAGTGCGG	AATTAGCCGGTCCTTATTCATG
Pig19Fw:Pig77Rv	ACGCTGAAGCTCGAAAGTGCGG	CGTCATCCTGCACGCTACTTGG
Pig19Fw:Pig78Rv	ACGCTGAAGCTCGAAAGTGCGG	TACGTATTACCGCGGCTGCTGG
Pig19Fw:Pig79Rv	ACGCTGAAGCTCGAAAGTGCGG	ATCCTGCACGCTACTTGGCTGG
Pig19Fw:Pig80Rv	ACGCTGAAGCTCGAAAGTGCGG	AAGCAGTTTACAACCCATAGGG
Pig19Fw:Pig81Rv	ACGCTGAAGCTCGAAAGTGCGG	GGTAAGCTGCCTTCGCAATCGG
Pig19Fw:Pig82Rv	ACGCTGAAGCTCGAAAGTGCGG	TAGCCGGTCCTTATTCATGCGG
Pig19Fw:Pig83Rv	ACGCTGAAGCTCGAAAGTGCGG	TGCCACCTACGTATTACCGCGG
Pig19Fw:Pig84Rv	ACGCTGAAGCTCGAAAGTGCGG	CGCATTTCACCGCTACACTAGG
Pig19Fw:Pig85Rv	ACGCTGAAGCTCGAAAGTGCGG	AAAGCAGTTTACAACCCATAGG
Pig19Fw:Pig86Rv	ACGCTGAAGCTCGAAAGTGCGG	ACGCTACGGTAAGCTGCCTTCG
Pig19Fw:Pig87Rv	ACGCTGAAGCTCGAAAGTGCGG	CGGTAAGCTGCCTTCGCAATCG
Pig19Fw:Pig88Rv	ACGCTGAAGCTCGAAAGTGCGG	TTAGCCGGTCCTTATTCATGCG
Pig19Fw:Pig89Rv	ACGCTGAAGCTCGAAAGTGCGG	TCGCATCCTCCGTATTACCGCG
Pig19Fw:Pig90Rv	ACGCTGAAGCTCGAAAGTGCGG	TTGCCACCTACGTATTACCGCG
Pig19Fw:Pig91Rv	ACGCTGAAGCTCGAAAGTGCGG	TCGCCACCTACGTATTACCGCG
Pig19Fw:Pig92Rv	ACGCTGAAGCTCGAAAGTGCGG	CAGTTTACAACCCATAGGGCCG
Pig19Fw:Pig93Rv	ACGCTGAAGCTCGAAAGTGCGG	GCTCGCATCCTCCGTATTACCG
Pig19Fw:Pig94Rv	ACGCTGAAGCTCGAAAGTGCGG	GCTTGCCACCTACGTATTACCG
Pig19Fw:Pig95Rv	ACGCTGAAGCTCGAAAGTGCGG	GCTCGCCACCTACGTATTACCG
Pig19Fw:Pig96Rv	ACGCTGAAGCTCGAAAGTGCGG	CTAATATCTACGCATTTCACCG
Pig19Fw:Pig97Rv	ACGCTGAAGCTCGAAAGTGCGG	GGTGTTCCTCCTAATATCTACG
Pig19Fw:Pig98Rv	ACGCTGAAGCTCGAAAGTGCGG	CACCCAGTAAATCCGGACAACG
Pig19Fw:Pig99Rv	ACGCTGAAGCTCGAAAGTGCGG	ACGCATTTCACCGCTACACTAG
Pig19Fw:Pig100Rv	ACGCTGAAGCTCGAAAGTGCGG	TAAGCTGCCTTCGCAATCGGAG
Pig19Fw:Pig101Rv	ACGCTGAAGCTCGAAAGTGCGG	GCACGCTACTTGGCTGGTTCAG
Pig19Fw:Pig102Rv	ACGCTGAAGCTCGAAAGTGCGG	TCACGCGACTTGGCTGGTTCAG
Pig19Fw:Pig103Rv	ACGCTGAAGCTCGAAAGTGCGG	TACCCGCACTTTCGAGCTTCAG
Pig19Fw:Pig104Rv	ACGCTGAAGCTCGAAAGTGCGG	GGAGTTCTTCGTGATATCTAAG
Pig19Fw:Pig105Rv	ACGCTGAAGCTCGAAAGTGCGG	CCTCCTAATATCTACGCATTTC
Pig19Fw:Pig106Rv	ACGCTGAAGCTCGAAAGTGCGG	CTGCACGCTACTTGGCTGGTTC
Pig19Fw:Pig107Rv	ACGCTGAAGCTCGAAAGTGCGG	GCTGCCTTCGCAATCGGAGTTC
Pig19Fw:Pig108Rv	ACGCTGAAGCTCGAAAGTGCGG	GATACCCGCACTTTCGAGCTTC
Pig19Fw:Pig109Rv	ACGCTGAAGCTCGAAAGTGCGG	AACGCTACGGTAAGCTGCCTTC
Pig19Fw:Pig110Rv	ACGCTGAAGCTCGAAAGTGCGG	TTCACCGCTACACTAGGAATTC
Pig19Fw:Pig111Rv	ACGCTGAAGCTCGAAAGTGCGG	CGCACTTTCGAGCTTCAGCGTC
Pig19Fw:Pig112Rv	ACGCTGAAGCTCGAAAGTGCGG	TTGGCTGGTTCAGACTTCCGTC
Pig19Fw:Pig113Rv	ACGCTGAAGCTCGAAAGTGCGG	GTTTACAACCCATAGGGCCGTC
Pig19Fw:Pig114Rv	ACGCTGAAGCTCGAAAGTGCGG	TTGGCTGGTTCAGACTTACGTC
Pig19Fw:Pig115Rv	ACGCTGAAGCTCGAAAGTGCGG	CACCACGAATTCCGCCTACCTC
Pig19Fw:Pig116Rv	ACGCTGAAGCTCGAAAGTGCGG	AATCGGAGTTCTTCGTGATATC
Pig19Fw:Pig117Rv	ACGCTGAAGCTCGAAAGTGCGG	CACTGGTGTTCCTCCTAATATC
Pig19Fw:Pig118Rv	ACGCTGAAGCTCGAAAGTGCGG	TACAACCCATAGGGCCGTCATC
Pig19Fw:Pig119Rv	ACGCTGAAGCTCGAAAGTGCGG	ACGGTAAGCTGCCTTCGCAATC
Pig19Fw:Pig120Rv	ACGCTGAAGCTCGAAAGTGCGG	AGTAAATCCGGACAACGCTTGC
Pig19Fw:Pig121Rv	ACGCTGAAGCTCGAAAGTGCGG	GCCTTCGCAATCGGAGTTCTGC
Pig19Fw:Pig122Rv	ACGCTGAAGCTCGAAAGTGCGG	ACCTACGTATTACCGCGGCTGC
Pig19Fw:Pig123Rv	ACGCTGAAGCTCGAAAGTGCGG	TCCTTATTCATGCGGTACCTGC
Pig19Fw:Pig124Rv	ACGCTGAAGCTCGAAAGTGCGG	ATTAGCCGGTCCTTATTCATGC
Pig19Fw:Pig125Rv	ACGCTGAAGCTCGAAAGTGCGG	GTCATCCTGCACGCTACTTGGC
Pig19Fw:Pig126Rv	ACGCTGAAGCTCGAAAGTGCGG	AGCAGTTTACAACCCATAGGGC
Pig19Fw:Pig127Rv	ACGCTGAAGCTCGAAAGTGCGG	CTCGCATCCTCCGTATTACCGC
Pig19Fw:Pig128Rv	ACGCTGAAGCTCGAAAGTGCGG	CTTGCCACCTACGTATTACCGC
Pig19Fw:Pig129Rv	ACGCTGAAGCTCGAAAGTGCGG	CTCGCCACCTACGTATTACCGC
Pig19Fw:Pig130Rv	ACGCTGAAGCTCGAAAGTGCGG	TAATATCTACGCATTTCACCGC
Pig19Fw:Pig131Rv	ACGCTGAAGCTCGAAAGTGCGG	TGATATCTAAGCATTTCACCGC
Pig19Fw:Pig132Rv	ACGCTGAAGCTCGAAAGTGCGG	GTGTTCCTCCTAATATCTACGC
Pig19Fw:Pig133Rv	ACGCTGAAGCTCGAAAGTGCGG	ACCCAGTAAATCCGGACAACGC
Pig19Fw:Pig134Rv	ACGCTGAAGCTCGAAAGTGCGG	ACCCGCACTTTCGAGCTTCAGC
Pig19Fw:Pig135Rv	ACGCTGAAGCTCGAAAGTGCGG	GAGTTCTTCGTGATATCTAAGC
Pig19Fw:Pig136Rv	ACGCTGAAGCTCGAAAGTGCGG	TGGCTGGTTCAGACTTCCGTCC
Pig19Fw:Pig137Rv	ACGCTGAAGCTCGAAAGTGCGG	TGGCTGGTTCAGACTTACGTCC
Pig19Fw:Pig138Rv	ACGCTGAAGCTCGAAAGTGCGG	ACCACGAATTCCGCCTACCTCC
Pig19Fw:Pig139Rv	ACGCTGAAGCTCGAAAGTGCGG	ACAACCCATAGGGCCGTCATCC
Pig19Fw:Pig140Rv	ACGCTGAAGCTCGAAAGTGCGG	GCAGTTTACAACCCATAGGGCC
Pig19Fw:Pig141Rv	ACGCTGAAGCTCGAAAGTGCGG	GGCCTACGCTCCCTTTAAACCC
Pig19Fw:Pig142Rv	ACGCTGAAGCTCGAAAGTGCGG	CGCTCGCATCCTCCGTATTACC
Pig19Fw:Pig143Rv	ACGCTGAAGCTCGAAAGTGCGG	CGCTTGCCACCTACGTATTACC
Pig19Fw:Pig144Rv	ACGCTGAAGCTCGAAAGTGCGG	CGCTCGCCACCTACGTATTACC
Pig19Fw:Pig145Rv	ACGCTGAAGCTCGAAAGTGCGG	TACACCACGAATTCCGCCTACC
Pig19Fw:Pig146Rv	ACGCTGAAGCTCGAAAGTGCGG	TTCAGACTTCCGTCCATTGACC
Pig19Fw:Pig147Rv	ACGCTGAAGCTCGAAAGTGCGG	TTCAGACTTACGTCCATTGACC
Pig19Fw:Pig148Rv	ACGCTGAAGCTCGAAAGTGCGG	CCTAATATCTACGCATTTCACC
Pig19Fw:Pig149Rv	ACGCTGAAGCTCGAAAGTGCGG	CGGCCTACGCTCCCTTTAAACC
Pig19Fw:Pig150Rv	ACGCTGAAGCTCGAAAGTGCGG	ACGCTCGCATCCTCCGTATTAC
Pig19Fw:Pig151Rv	ACGCTGAAGCTCGAAAGTGCGG	ACGCTTGCCACCTACGTATTAC
Pig19Fw:Pig152Rv	ACGCTGAAGCTCGAAAGTGCGG	ACGCTCGCCACCTACGTATTAC
Pig19Fw:Pig153Rv	ACGCTGAAGCTCGAAAGTGCGG	TGGTGTTCCTCCTAATATCTAC
Pig19Fw:Pig154Rv	ACGCTGAAGCTCGAAAGTGCGG	TATCTATGCATTTCACCGCTAC
Pig19Fw:Pig155Rv	ACGCTGAAGCTCGAAAGTGCGG	TATCTAAGCATTTCACCGCTAC
Pig19Fw:Pig156Rv	ACGCTGAAGCTCGAAAGTGCGG	GTTCAGACTTCCGTCCATTGAC
Pig19Fw:Pig157Rv	ACGCTGAAGCTCGAAAGTGCGG	GTTCAGACTTACGTCCATTGAC
Pig19Fw:Pig158Rv	ACGCTGAAGCTCGAAAGTGCGG	ACGCTACTTGGCTGGTTCAGAC
Pig19Fw:Pig159Rv	ACGCTGAAGCTCGAAAGTGCGG	TCTATGCATTTCACCGCTACAC
Pig19Fw:Pig160Rv	ACGCTGAAGCTCGAAAGTGCGG	TCTAAGCATTTCACCGCTACAC
Pig19Fw:Pig161Rv	ACGCTGAAGCTCGAAAGTGCGG	ACACCCAGTAAATCCGGACAAC
Pig19Fw:Pig162Rv	ACGCTGAAGCTCGAAAGTGCGG	CCGGCCTACGCTCCCTTTAAAC
Pig19Fw:Pig163Rv	ACGCTGAAGCTCGAAAGTGCGG	ACGGCCTACGCTCCCTTTAAAC
Pig19Fw:Pig164Rv	ACGCTGAAGCTCGAAAGTGCGG	AAGCCGGCCTACGCTCCCTTTA
Pig19Fw:Pig165Rv	ACGCTGAAGCTCGAAAGTGCGG	GCGGCATTTCACAACACGCTTA
Pig19Fw:Pig166Rv	ACGCTGAAGCTCGAAAGTGCGG	GCACGGAATTAGCCGGTCCTTA
Pig19Fw:Pig167Rv	ACGCTGAAGCTCGAAAGTGCGG	AACGCTCGCATCCTCCGTATTA
Pig19Fw:Pig168Rv	ACGCTGAAGCTCGAAAGTGCGG	AACGCTTGCCACCTACGTATTA
Pig19Fw:Pig169Rv	ACGCTGAAGCTCGAAAGTGCGG	AACGCTCGCCACCTACGTATTA
Pig19Fw:Pig170Rv	ACGCTGAAGCTCGAAAGTGCGG	GATAACGCTCGCATCCTCCGTA
Pig19Fw:Pig171Rv	ACGCTGAAGCTCGAAAGTGCGG	GACAACGCTTGCCACCTACGTA
Pig19Fw:Pig172Rv	ACGCTGAAGCTCGAAAGTGCGG	TCGGAGTTCTTCGTGATATCTA
Pig19Fw:Pig173Rv	ACGCTGAAGCTCGAAAGTGCGG	CTGGTGTTCCTCCTAATATCTA
Pig19Fw:Pig174Rv	ACGCTGAAGCTCGAAAGTGCGG	ATATCTACGCATTTCACCGCTA
Pig19Fw:Pig175Rv	ACGCTGAAGCTCGAAAGTGCGG	TTCGCCACTGGTGTTCCTCCTA
Pig19Fw:Pig176Rv	ACGCTGAAGCTCGAAAGTGCGG	GCTACACCACGAATTCCGCCTA
Pig19Fw:Pig177Rv	ACGCTGAAGCTCGAAAGTGCGG	TCCGGACAACGCTTGCCACCTA
Pig19Fw:Pig178Rv	ACGCTGAAGCTCGAAAGTGCGG	TACGCATTTCACCGCTACACTA
Pig19Fw:Pig179Rv	ACGCTGAAGCTCGAAAGTGCGG	GCAATCGGAGTTCTTCGTGATA
Pig19Fw:Pig180Rv	ACGCTGAAGCTCGAAAGTGCGG	GCCACTGGTGTTCCTCCTAATA
Pig19Fw:Pig181Rv	ACGCTGAAGCTCGAAAGTGCGG	TACGCTCCCTTTAAACCCAATA
Pig19Fw:Pig182Rv	ACGCTGAAGCTCGAAAGTGCGG	GGTTCAGACTTCCGTCCATTGA
Pig19Fw:Pig183Rv	ACGCTGAAGCTCGAAAGTGCGG	GGTTCAGACTTACGTCCATTGA
Pig19Fw:Pig184Rv	ACGCTGAAGCTCGAAAGTGCGG	TCGCAATCGGAGTTCTTCGTGA
Pig19Fw:Pig185Rv	ACGCTGAAGCTCGAAAGTGCGG	GTAAGCTGCCTTCGCAATCGGA
Pig19Fw:Pig186Rv	ACGCTGAAGCTCGAAAGTGCGG	GCATTTCACCGCTACACTAGGA
Pig19Fw:Pig187Rv	ACGCTGAAGCTCGAAAGTGCGG	CACGCTACTTGGCTGGTTCAGA
Pig19Fw:Pig188Rv	ACGCTGAAGCTCGAAAGTGCGG	TGCACGCTACTTGGCTGGTTCA
Pig19Fw:Pig189Rv	ACGCTGAAGCTCGAAAGTGCGG	ATACCCGCACTTTCGAGCTTCA
Pig19Fw:Pig190Rv	ACGCTGAAGCTCGAAAGTGCGG	GCACTTTCGAGCTTCAGCGTCA
Pig19Fw:Pig191Rv	ACGCTGAAGCTCGAAAGTGCGG	TTTACAACCCATAGGGCCGTCA
Pig19Fw:Pig192Rv	ACGCTGAAGCTCGAAAGTGCGG	CCTTATTCATGCGGTACCTGCA
Pig19Fw:Pig193Rv	ACGCTGAAGCTCGAAAGTGCGG	GCTACGGTAAGCTGCCTTCGCA
Pig19Fw:Pig194Rv	ACGCTGAAGCTCGAAAGTGCGG	TGTTCCTCCTAATATCTACGCA
Pig19Fw:Pig195Rv	ACGCTGAAGCTCGAAAGTGCGG	GGCTGGTTCAGACTTCCGTCCA
Pig19Fw:Pig196Rv	ACGCTGAAGCTCGAAAGTGCGG	GGCTGGTTCAGACTTACGTCCA
Pig19Fw:Pig197Rv	ACGCTGAAGCTCGAAAGTGCGG	GCCTACGCTCCCTTTAAACCCA
Pig19Fw:Pig198Rv	ACGCTGAAGCTCGAAAGTGCGG	TCAGACTTCCGTCCATTGACCA
Pig19Fw:Pig199Rv	ACGCTGAAGCTCGAAAGTGCGG	TCAGACTTACGTCCATTGACCA
Pig19Fw:Pig200Rv	ACGCTGAAGCTCGAAAGTGCGG	ATCTATGCATTTCACCGCTACA
Pig19Fw:Pig201Rv	ACGCTGAAGCTCGAAAGTGCGG	ATCTAAGCATTTCACCGCTACA
Pig19Fw:Pig202Rv	ACGCTGAAGCTCGAAAGTGCGG	AGCCGGCCTACGCTCCCTTTAA
Pig19Fw:Pig203Rv	ACGCTGAAGCTCGAAAGTGCGG	CGGCATTTCACAACACGCTTAA
Pig19Fw:Pig204Rv	ACGCTGAAGCTCGAAAGTGCGG	CGGAGTTCTTCGTGATATCTAA
Pig19Fw:Pig205Rv	ACGCTGAAGCTCGAAAGTGCGG	TCGCCACTGGTGTTCCTCCTAA
Pig19Fw:Pig206Rv	ACGCTGAAGCTCGAAAGTGCGG	ACGCTCCCTTTAAACCCAATAA
Pig19Fw:Pig207Rv	ACGCTGAAGCTCGAAAGTGCGG	CATTTCACCGCTACACTAGGAA
Pig19Fw:Pig208Rv	ACGCTGAAGCTCGAAAGTGCGG	CTTATTCATGCGGTACCTGCAA
Pig19Fw:Pig209Rv	ACGCTGAAGCTCGAAAGTGCGG	CTACGGTAAGCTGCCTTCGCAA
Pig19Fw:Pig210Rv	ACGCTGAAGCTCGAAAGTGCGG	CCTACGCTCCCTTTAAACCCAA
Pig19Fw:Pig211Rv	ACGCTGAAGCTCGAAAGTGCGG	CAGACTTCCGTCCATTGACCAA
Pig19Fw:Pig212Rv	ACGCTGAAGCTCGAAAGTGCGG	CAGACTTACGTCCATTGACCAA
Pig19Fw:Pig213Rv	ACGCTGAAGCTCGAAAGTGCGG	TACACCCAGTAAATCCGGACAA
Pig19Fw:Pig214Rv	ACGCTGAAGCTCGAAAGTGCGG	GCCGGCCTACGCTCCCTTTAAA
Pig19Fw:Pig215Rv	ACGCTGAAGCTCGAAAGTGCGG	GGCATTTCACAACACGCTTAAA
Pig19Fw:Pig216Rv	ACGCTGAAGCTCGAAAGTGCGG	TTATTCATGCGGTACCTGCAAA
Pig19Fw:Pig217Rv	ACGCTGAAGCTCGAAAGTGCGG	GCACGGAGTTAGCCGATGCTTT
Pig19Fw:Pig218Rv	ACGCTGAAGCTCGAAAGTGCGG	CCTTCACGCGACTTGGCTGGTT
Pig19Fw:Pig219Rv	ACGCTGAAGCTCGAAAGTGCGG	ACGGAGTTAGCCGATGCTTATT
Pig19Fw:Pig220Rv	ACGCTGAAGCTCGAAAGTGCGG	CAACGCTCGCCACCTACGTATT
Pig19Fw:Pig221Rv	ACGCTGAAGCTCGAAAGTGCGG	TTTCACCGCTACACAACGCATT
Pig19Fw:Pig222Rv	ACGCTGAAGCTCGAAAGTGCGG	CTGGTTCAGGCTCTCGCCCATT
Pig19Fw:Pig223Rv	ACGCTGAAGCTCGAAAGTGCGG	TTTCACCGCTACACGACGAATT
Pig19Fw:Pig224Rv	ACGCTGAAGCTCGAAAGTGCGG	TCCTTCACGCGACTTGGCTGGT
Pig19Fw:Pig225Rv	ACGCTGAAGCTCGAAAGTGCGG	ATCGGAGTTCTGCGTCATATCT
Pig19Fw:Pig226Rv	ACGCTGAAGCTCGAAAGTGCGG	TCGTCCTGCACGCTACTTGGCT
Pig19Fw:Pig227Rv	ACGCTGAAGCTCGAAAGTGCGG	CCCAGTAATTCCGGACAACGCT
Pig19Fw:Pig228Rv	ACGCTGAAGCTCGAAAGTGCGG	ATCCGGACAACGCTTGCCACCT
Pig19Fw:Pig229Rv	ACGCTGAAGCTCGAAAGTGCGG	CACGGAGTTAGCCGATGCTTAT
Pig19Fw:Pig230Rv	ACGCTGAAGCTCGAAAGTGCGG	ACAACGCTCGCCACCTACGTAT
Pig19Fw:Pig231Rv	ACGCTGAAGCTCGAAAGTGCGG	CGGAGTTCTGCGTCATATCTAT
Pig19Fw:Pig232Rv	ACGCTGAAGCTCGAAAGTGCGG	CAATCGGAGTTCTGCGTCATAT
Pig19Fw:Pig233Rv	ACGCTGAAGCTCGAAAGTGCGG	ATTTCACCGCTACACAACGCAT
Pig19Fw:Pig234Rv	ACGCTGAAGCTCGAAAGTGCGG	ATTTCACCGCTACACGACGAAT
Pig19Fw:Pig235Rv	ACGCTGAAGCTCGAAAGTGCGG	TGGTTCAGGCTCTCGCCCATTG
Pig19Fw:Pig236Rv	ACGCTGAAGCTCGAAAGTGCGG	AAAGAGGTTTACAATCCGTAGG
Pig19Fw:Pig237Rv	ACGCTGAAGCTCGAAAGTGCGG	CACGCTACTTGGCTGGTTCAGG
Pig19Fw:Pig238Rv	ACGCTGAAGCTCGAAAGTGCGG	CACCGCTACACAACGCATTCCG
Pig19Fw:Pig239Rv	ACGCTGAAGCTCGAAAGTGCGG	CCCTTTACGCCCAATAATTCCG
Pig19Fw:Pig240Rv	ACGCTGAAGCTCGAAAGTGCGG	CACCGCTACACGACGAATTCCG
Pig19Fw:Pig241Rv	ACGCTGAAGCTCGAAAGTGCGG	GTCATATCTAAGCATTTCACCG
Pig19Fw:Pig242Rv	ACGCTGAAGCTCGAAAGTGCGG	AGCATTTCACCGCTACACGACG
Pig19Fw:Pig243Rv	ACGCTGAAGCTCGAAAGTGCGG	CTAAGCATTTCACCGCTACACG
Pig19Fw:Pig244Rv	ACGCTGAAGCTCGAAAGTGCGG	CACCCAGTAATTCCGGACAACG
Pig19Fw:Pig245Rv	ACGCTGAAGCTCGAAAGTGCGG	TGCATTTCACCGCTACACAACG
Pig19Fw:Pig246Rv	ACGCTGAAGCTCGAAAGTGCGG	CAAGCTGCCTTCGCAATCGGAG
Pig19Fw:Pig247Rv	ACGCTGAAGCTCGAAAGTGCGG	CTTCACGCGACTTGGCTGGTTC
Pig19Fw:Pig248Rv	ACGCTGAAGCTCGAAAGTGCGG	CGGAGTTAGCCGATGCTTATTC
Pig19Fw:Pig249Rv	ACGCTGAAGCTCGAAAGTGCGG	TTCACCGCTACACAACGCATTC
Pig19Fw:Pig250Rv	ACGCTGAAGCTCGAAAGTGCGG	TTCACCGCTACACGACGAATTC
Pig19Fw:Pig251Rv	ACGCTGAAGCTCGAAAGTGCGG	AATCGGAGTTCTGCGTCATATC
Pig19Fw:Pig252Rv	ACGCTGAAGCTCGAAAGTGCGG	ACGCTACTTGGCTGGTTCAGGC
Pig19Fw:Pig253Rv	ACGCTGAAGCTCGAAAGTGCGG	TCATATCTAAGCATTTCACCGC
Pig19Fw:Pig254Rv	ACGCTGAAGCTCGAAAGTGCGG	ACCCAGTAATTCCGGACAACGC
Pig19Fw:Pig255Rv	ACGCTGAAGCTCGAAAGTGCGG	GCATTTCACCGCTACACAACGC
Pig19Fw:Pig256Rv	ACGCTGAAGCTCGAAAGTGCGG	TCACCGCTACACAACGCATTCC
Pig19Fw:Pig257Rv	ACGCTGAAGCTCGAAAGTGCGG	TCACCGCTACACGACGAATTCC
Pig19Fw:Pig258Rv	ACGCTGAAGCTCGAAAGTGCGG	GTAAATCCGGACAACGCTTGCC
Pig19Fw:Pig259Rv	ACGCTGAAGCTCGAAAGTGCGG	TTCAGGCTCTCGCCCATTGACC
Pig19Fw:Pig260Rv	ACGCTGAAGCTCGAAAGTGCGG	GAGGTTTACAATCCGTAGGACC
Pig19Fw:Pig261Rv	ACGCTGAAGCTCGAAAGTGCGG	CGTCATATCTAAGCATTTCACC
Pig19Fw:Pig262Rv	ACGCTGAAGCTCGAAAGTGCGG	AATCCGGACAACGCTTGCCACC
Pig19Fw:Pig263Rv	ACGCTGAAGCTCGAAAGTGCGG	CCGCCTACGCACCCTTTAAACC
Pig19Fw:Pig264Rv	ACGCTGAAGCTCGAAAGTGCGG	GTTCAGGCTCTCGCCCATTGAC
Pig19Fw:Pig265Rv	ACGCTGAAGCTCGAAAGTGCGG	AGAGGTTTACAATCCGTAGGAC
Pig19Fw:Pig266Rv	ACGCTGAAGCTCGAAAGTGCGG	AAGCATTTCACCGCTACACGAC
Pig19Fw:Pig267Rv	ACGCTGAAGCTCGAAAGTGCGG	AAATCCGGACAACGCTTGCCAC
Pig19Fw:Pig268Rv	ACGCTGAAGCTCGAAAGTGCGG	AATTCCGGACAACGCTCGCCAC
Pig19Fw:Pig269Rv	ACGCTGAAGCTCGAAAGTGCGG	ACACCCAGTAATTCCGGACAAC
Pig19Fw:Pig270Rv	ACGCTGAAGCTCGAAAGTGCGG	ATGCATTTCACCGCTACACAAC
Pig19Fw:Pig271Rv	ACGCTGAAGCTCGAAAGTGCGG	GCACGGAGTTAGCCGATGCTTA
Pig19Fw:Pig272Rv	ACGCTGAAGCTCGAAAGTGCGG	GACAACGCTCGCCACCTACGTA
Pig19Fw:Pig273Rv	ACGCTGAAGCTCGAAAGTGCGG	TCGGAGTTCTGCGTCATATCTA
Pig19Fw:Pig274Rv	ACGCTGAAGCTCGAAAGTGCGG	GCAATCGGAGTTCTGCGTCATA
Pig19Fw:Pig275Rv	ACGCTGAAGCTCGAAAGTGCGG	GGTTCAGGCTCTCGCCCATTGA
Pig19Fw:Pig276Rv	ACGCTGAAGCTCGAAAGTGCGG	CTTTACGCCCAATAATTCCGGA
Pig19Fw:Pig277Rv	ACGCTGAAGCTCGAAAGTGCGG	AAGAGGTTTACAATCCGTAGGA
Pig19Fw:Pig278Rv	ACGCTGAAGCTCGAAAGTGCGG	GCATTTCACCGCTACACGACGA
Pig19Fw:Pig279Rv	ACGCTGAAGCTCGAAAGTGCGG	TAAGCATTTCACCGCTACACGA
Pig19Fw:Pig280Rv	ACGCTGAAGCTCGAAAGTGCGG	CTCACGCGACTTGGCTGGTTCA
Pig19Fw:Pig281Rv	ACGCTGAAGCTCGAAAGTGCGG	CATTTCACCGCTACACAACGCA
Pig19Fw:Pig282Rv	ACGCTGAAGCTCGAAAGTGCGG	TAAATCCGGACAACGCTTGCCA
Pig19Fw:Pig283Rv	ACGCTGAAGCTCGAAAGTGCGG	TAATTCCGGACAACGCTCGCCA
Pig19Fw:Pig284Rv	ACGCTGAAGCTCGAAAGTGCGG	TCAGGCTCTCGCCCATTGACCA
Pig19Fw:Pig285Rv	ACGCTGAAGCTCGAAAGTGCGG	CTATGCATTTCACCGCTACACA
Pig19Fw:Pig286Rv	ACGCTGAAGCTCGAAAGTGCGG	CATTTCACCGCTACACGACGAA
Pig19Fw:Pig287Rv	ACGCTGAAGCTCGAAAGTGCGG	CAGGCTCTCGCCCATTGACCAA
Pig19Fw:Pig288Rv	ACGCTGAAGCTCGAAAGTGCGG	TACACCCAGTAATTCCGGACAA
Pig19Fw:Pig289Rv	ACGCTGAAGCTCGAAAGTGCGG	TATGCATTTCACCGCTACACAA
Pig20Fw:Pig1Rv	ACGGAAGTCTGAACCAGCCAAG	CCTGCACGCTACTTGGCTGGTT
Pig20Fw:Pig2Rv	ACGGAAGTCTGAACCAGCCAAG	AGCTGCCTTCGCAATCGGAGTT
Pig20Fw:Pig3Rv	ACGGAAGTCTGAACCAGCCAAG	TGCCTTCGCAATCGGAGTTCTT
Pig20Fw:Pig4Rv	ACGGAAGTCTGAACCAGCCAAG	GGCACGGAGTTAGCCGATGCTT
Pig20Fw:Pig5Rv	ACGGAAGTCTGAACCAGCCAAG	CGCGGCATTTCACAACACGCTT
Pig20Fw:Pig6Rv	ACGGAAGTCTGAACCAGCCAAG	CCAGTAAATCCGGACAACGCTT
Pig20Fw:Pig7Rv	ACGGAAGTCTGAACCAGCCAAG	CGATACCCGCACTTTCGAGCTT
Pig20Fw:Pig8Rv	ACGGAAGTCTGAACCAGCCAAG	GGCACGGAATTAGCCGGTCCTT
Pig20Fw:Pig9Rv	ACGGAAGTCTGAACCAGCCAAG	TAACGCTACGGTAAGCTGCCTT
Pig20Fw:Pig10Rv	ACGGAAGTCTGAACCAGCCAAG	GCCGTCATCCTGCACGCTACTT
Pig20Fw:Pig11Rv	ACGGAAGTCTGAACCAGCCAAG	ACGGAATTAGCCGGTCCTTATT
Pig20Fw:Pig12Rv	ACGGAAGTCTGAACCAGCCAAG	TAACGCTCGCATCCTCCGTATT
Pig20Fw:Pig13Rv	ACGGAAGTCTGAACCAGCCAAG	CAACGCTTGCCACCTACGTATT
Pig20Fw:Pig14Rv	ACGGAAGTCTGAACCAGCCAAG	CTGGTTCAGACTTCCGTCCATT
Pig20Fw:Pig15Rv	ACGGAAGTCTGAACCAGCCAAG	CTGGTTCAGACTTACGTCCATT
Pig20Fw:Pig16Rv	ACGGAAGTCTGAACCAGCCAAG	TTTCACCGCTACACTAGGAATT
Pig20Fw:Pig17Rv	ACGGAAGTCTGAACCAGCCAAG	TCCTGCACGCTACTTGGCTGGT
Pig20Fw:Pig18Rv	ACGGAAGTCTGAACCAGCCAAG	TGCTGGCACGGAATTAGCCGGT
Pig20Fw:Pig19Rv	ACGGAAGTCTGAACCAGCCAAG	CCGCACTTTCGAGCTTCAGCGT
Pig20Fw:Pig20Rv	ACGGAAGTCTGAACCAGCCAAG	CTTGGCTGGTTCAGACTTCCGT
Pig20Fw:Pig21Rv	ACGGAAGTCTGAACCAGCCAAG	AGTTTACAACCCATAGGGCCGT
Pig20Fw:Pig22Rv	ACGGAAGTCTGAACCAGCCAAG	CTGCTGGCACGTAGTTAGCCGT
Pig20Fw:Pig23Rv	ACGGAAGTCTGAACCAGCCAAG	CTTGGCTGGTTCAGACTTACGT
Pig20Fw:Pig24Rv	ACGGAAGTCTGAACCAGCCAAG	GGACAACGCTTGCCACCTACGT
Pig20Fw:Pig25Rv	ACGGAAGTCTGAACCAGCCAAG	AAGCTGCCTTCGCAATCGGAGT
Pig20Fw:Pig26Rv	ACGGAAGTCTGAACCAGCCAAG	CTGCCTTCGCAATCGGAGTTCT
Pig20Fw:Pig27Rv	ACGGAAGTCTGAACCAGCCAAG	ATCGGAGTTCTTCGTGATATCT
Pig20Fw:Pig28Rv	ACGGAAGTCTGAACCAGCCAAG	ACTGGTGTTCCTCCTAATATCT
Pig20Fw:Pig29Rv	ACGGAAGTCTGAACCAGCCAAG	CTTCCGTATTACCGCGGCTGCT
Pig20Fw:Pig30Rv	ACGGAAGTCTGAACCAGCCAAG	CCTACGTATTACCGCGGCTGCT
Pig20Fw:Pig31Rv	ACGGAAGTCTGAACCAGCCAAG	TGGCACGGAGTTAGCCGATGCT
Pig20Fw:Pig32Rv	ACGGAAGTCTGAACCAGCCAAG	TCATCCTGCACGCTACTTGGCT
Pig20Fw:Pig33Rv	ACGGAAGTCTGAACCAGCCAAG	GACCTTCCGTATTACCGCGGCT
Pig20Fw:Pig34Rv	ACGGAAGTCTGAACCAGCCAAG	CATCCTCCGTATTACCGCGGCT
Pig20Fw:Pig35Rv	ACGGAAGTCTGAACCAGCCAAG	CCACCTACGTATTACCGCGGCT
Pig20Fw:Pig36Rv	ACGGAAGTCTGAACCAGCCAAG	AATATCTACGCATTTCACCGCT
Pig20Fw:Pig37Rv	ACGGAAGTCTGAACCAGCCAAG	GATATCTAAGCATTTCACCGCT
Pig20Fw:Pig38Rv	ACGGAAGTCTGAACCAGCCAAG	CATATCTAAGCATTTCACCGCT
Pig20Fw:Pig39Rv	ACGGAAGTCTGAACCAGCCAAG	CCGCGGCATTTCACAACACGCT
Pig20Fw:Pig40Rv	ACGGAAGTCTGAACCAGCCAAG	CCCAGTAAATCCGGACAACGCT
Pig20Fw:Pig41Rv	ACGGAAGTCTGAACCAGCCAAG	TGGCACGGAATTAGCCGGTCCT
Pig20Fw:Pig42Rv	ACGGAAGTCTGAACCAGCCAAG	CTTCGCCACTGGTGTTCCTCCT
Pig20Fw:Pig43Rv	ACGGAAGTCTGAACCAGCCAAG	CAACCCATAGGGCCGTCATCCT
Pig20Fw:Pig44Rv	ACGGAAGTCTGAACCAGCCAAG	CGCTACACCACGAATTCCGCCT
Pig20Fw:Pig45Rv	ACGGAAGTCTGAACCAGCCAAG	GGTCCTTATTCATGCGGTACCT
Pig20Fw:Pig46Rv	ACGGAAGTCTGAACCAGCCAAG	ACACCACGAATTCCGCCTACCT
Pig20Fw:Pig47Rv	ACGGAAGTCTGAACCAGCCAAG	CGCTACTTGGCTGGTTCAGACT
Pig20Fw:Pig48Rv	ACGGAAGTCTGAACCAGCCAAG	CACGGAATTAGCCGGTCCTTAT
Pig20Fw:Pig49Rv	ACGGAAGTCTGAACCAGCCAAG	ATAACGCTCGCATCCTCCGTAT
Pig20Fw:Pig50Rv	ACGGAAGTCTGAACCAGCCAAG	ACAACGCTTGCCACCTACGTAT
Pig20Fw:Pig51Rv	ACGGAAGTCTGAACCAGCCAAG	CAATCGGAGTTCTTCGTGATAT
Pig20Fw:Pig52Rv	ACGGAAGTCTGAACCAGCCAAG	CCACTGGTGTTCCTCCTAATAT
Pig20Fw:Pig53Rv	ACGGAAGTCTGAACCAGCCAAG	CGCAATCGGAGTTCTTCGTGAT
Pig20Fw:Pig54Rv	ACGGAAGTCTGAACCAGCCAAG	TGCTGGCACGGAGTTAGCCGAT
Pig20Fw:Pig55Rv	ACGGAAGTCTGAACCAGCCAAG	TTACAACCCATAGGGCCGTCAT
Pig20Fw:Pig56Rv	ACGGAAGTCTGAACCAGCCAAG	GTTCCTCCTAATATCTACGCAT
Pig20Fw:Pig57Rv	ACGGAAGTCTGAACCAGCCAAG	GCTGGTTCAGACTTCCGTCCAT
Pig20Fw:Pig58Rv	ACGGAAGTCTGAACCAGCCAAG	GCTGGTTCAGACTTACGTCCAT
Pig20Fw:Pig59Rv	ACGGAAGTCTGAACCAGCCAAG	CGCCACTGGTGTTCCTCCTAAT
Pig20Fw:Pig60Rv	ACGGAAGTCTGAACCAGCCAAG	ATTTCACCGCTACACTAGGAAT
Pig20Fw:Pig61Rv	ACGGAAGTCTGAACCAGCCAAG	TACGGTAAGCTGCCTTCGCAAT
Pig20Fw:Pig62Rv	ACGGAAGTCTGAACCAGCCAAG	CTACGCTCCCTTTAAACCCAAT
Pig20Fw:Pig63Rv	ACGGAAGTCTGAACCAGCCAAG	CAGTAAATCCGGACAACGCTTG
Pig20Fw:Pig64Rv	ACGGAAGTCTGAACCAGCCAAG	CCGTCATCCTGCACGCTACTTG
Pig20Fw:Pig65Rv	ACGGAAGTCTGAACCAGCCAAG	TGGTTCAGACTTCCGTCCATTG
Pig20Fw:Pig66Rv	ACGGAAGTCTGAACCAGCCAAG	TGGTTCAGACTTACGTCCATTG
Pig20Fw:Pig67Rv	ACGGAAGTCTGAACCAGCCAAG	TGCCTTCGCAATCGGAGTTCTG
Pig20Fw:Pig68Rv	ACGGAAGTCTGAACCAGCCAAG	TTCCGTATTACCGCGGCTGCTG
Pig20Fw:Pig69Rv	ACGGAAGTCTGAACCAGCCAAG	CTACGTATTACCGCGGCTGCTG
Pig20Fw:Pig70Rv	ACGGAAGTCTGAACCAGCCAAG	CATCCTGCACGCTACTTGGCTG
Pig20Fw:Pig71Rv	ACGGAAGTCTGAACCAGCCAAG	ACCTTCCGTATTACCGCGGCTG
Pig20Fw:Pig72Rv	ACGGAAGTCTGAACCAGCCAAG	ATCCTCCGTATTACCGCGGCTG
Pig20Fw:Pig73Rv	ACGGAAGTCTGAACCAGCCAAG	CACCTACGTATTACCGCGGCTG
Pig20Fw:Pig74Rv	ACGGAAGTCTGAACCAGCCAAG	AACCCATAGGGCCGTCATCCTG
Pig20Fw:Pig75Rv	ACGGAAGTCTGAACCAGCCAAG	GTCCTTATTCATGCGGTACCTG
Pig20Fw:Pig76Rv	ACGGAAGTCTGAACCAGCCAAG	AATTAGCCGGTCCTTATTCATG
Pig20Fw:Pig77Rv	ACGGAAGTCTGAACCAGCCAAG	CGTCATCCTGCACGCTACTTGG
Pig20Fw:Pig78Rv	ACGGAAGTCTGAACCAGCCAAG	TACGTATTACCGCGGCTGCTGG
Pig20Fw:Pig79Rv	ACGGAAGTCTGAACCAGCCAAG	ATCCTGCACGCTACTTGGCTGG
Pig20Fw:Pig80Rv	ACGGAAGTCTGAACCAGCCAAG	AAGCAGTTTACAACCCATAGGG
Pig20Fw:Pig81Rv	ACGGAAGTCTGAACCAGCCAAG	GGTAAGCTGCCTTCGCAATCGG
Pig20Fw:Pig82Rv	ACGGAAGTCTGAACCAGCCAAG	TAGCCGGTCCTTATTCATGCGG
Pig20Fw:Pig83Rv	ACGGAAGTCTGAACCAGCCAAG	TGCCACCTACGTATTACCGCGG
Pig20Fw:Pig84Rv	ACGGAAGTCTGAACCAGCCAAG	CGCATTTCACCGCTACACTAGG
Pig20Fw:Pig85Rv	ACGGAAGTCTGAACCAGCCAAG	AAAGCAGTTTACAACCCATAGG
Pig20Fw:Pig86Rv	ACGGAAGTCTGAACCAGCCAAG	ACGCTACGGTAAGCTGCCTTCG
Pig20Fw:Pig87Rv	ACGGAAGTCTGAACCAGCCAAG	CGGTAAGCTGCCTTCGCAATCG
Pig20Fw:Pig88Rv	ACGGAAGTCTGAACCAGCCAAG	TTAGCCGGTCCTTATTCATGCG
Pig20Fw:Pig89Rv	ACGGAAGTCTGAACCAGCCAAG	TCGCATCCTCCGTATTACCGCG
Pig20Fw:Pig90Rv	ACGGAAGTCTGAACCAGCCAAG	TTGCCACCTACGTATTACCGCG
Pig20Fw:Pig91Rv	ACGGAAGTCTGAACCAGCCAAG	TCGCCACCTACGTATTACCGCG
Pig20Fw:Pig92Rv	ACGGAAGTCTGAACCAGCCAAG	CAGTTTACAACCCATAGGGCCG
Pig20Fw:Pig93Rv	ACGGAAGTCTGAACCAGCCAAG	GCTCGCATCCTCCGTATTACCG
Pig20Fw:Pig94Rv	ACGGAAGTCTGAACCAGCCAAG	GCTTGCCACCTACGTATTACCG
Pig20Fw:Pig95Rv	ACGGAAGTCTGAACCAGCCAAG	GCTCGCCACCTACGTATTACCG
Pig20Fw:Pig96Rv	ACGGAAGTCTGAACCAGCCAAG	CTAATATCTACGCATTTCACCG
Pig20Fw:Pig97Rv	ACGGAAGTCTGAACCAGCCAAG	GGTGTTCCTCCTAATATCTACG
Pig20Fw:Pig98Rv	ACGGAAGTCTGAACCAGCCAAG	CACCCAGTAAATCCGGACAACG
Pig20Fw:Pig99Rv	ACGGAAGTCTGAACCAGCCAAG	ACGCATTTCACCGCTACACTAG
Pig20Fw:Pig100Rv	ACGGAAGTCTGAACCAGCCAAG	TAAGCTGCCTTCGCAATCGGAG
Pig20Fw:Pig101Rv	ACGGAAGTCTGAACCAGCCAAG	GCACGCTACTTGGCTGGTTCAG
Pig20Fw:Pig102Rv	ACGGAAGTCTGAACCAGCCAAG	TCACGCGACTTGGCTGGTTCAG
Pig20Fw:Pig103Rv	ACGGAAGTCTGAACCAGCCAAG	TACCCGCACTTTCGAGCTTCAG
Pig20Fw:Pig104Rv	ACGGAAGTCTGAACCAGCCAAG	GGAGTTCTTCGTGATATCTAAG
Pig20Fw:Pig105Rv	ACGGAAGTCTGAACCAGCCAAG	CCTCCTAATATCTACGCATTTC
Pig20Fw:Pig106Rv	ACGGAAGTCTGAACCAGCCAAG	CTGCACGCTACTTGGCTGGTTC
Pig20Fw:Pig107Rv	ACGGAAGTCTGAACCAGCCAAG	GCTGCCTTCGCAATCGGAGTTC
Pig20Fw:Pig108Rv	ACGGAAGTCTGAACCAGCCAAG	GATACCCGCACTTTCGAGCTTC
Pig20Fw:Pig109Rv	ACGGAAGTCTGAACCAGCCAAG	AACGCTACGGTAAGCTGCCTTC
Pig20Fw:Pig110Rv	ACGGAAGTCTGAACCAGCCAAG	TTCACCGCTACACTAGGAATTC
Pig20Fw:Pig111Rv	ACGGAAGTCTGAACCAGCCAAG	CGCACTTTCGAGCTTCAGCGTC
Pig20Fw:Pig112Rv	ACGGAAGTCTGAACCAGCCAAG	TTGGCTGGTTCAGACTTCCGTC
Pig20Fw:Pig113Rv	ACGGAAGTCTGAACCAGCCAAG	GTTTACAACCCATAGGGCCGTC
Pig20Fw:Pig114Rv	ACGGAAGTCTGAACCAGCCAAG	TTGGCTGGTTCAGACTTACGTC
Pig20Fw:Pig115Rv	ACGGAAGTCTGAACCAGCCAAG	CACCACGAATTCCGCCTACCTC
Pig20Fw:Pig116Rv	ACGGAAGTCTGAACCAGCCAAG	AATCGGAGTTCTTCGTGATATC
Pig20Fw:Pig117Rv	ACGGAAGTCTGAACCAGCCAAG	CACTGGTGTTCCTCCTAATATC
Pig20Fw:Pig118Rv	ACGGAAGTCTGAACCAGCCAAG	TACAACCCATAGGGCCGTCATC
Pig20Fw:Pig119Rv	ACGGAAGTCTGAACCAGCCAAG	ACGGTAAGCTGCCTTCGCAATC
Pig20Fw:Pig120Rv	ACGGAAGTCTGAACCAGCCAAG	AGTAAATCCGGACAACGCTTGC
Pig20Fw:Pig121Rv	ACGGAAGTCTGAACCAGCCAAG	GCCTTCGCAATCGGAGTTCTGC
Pig20Fw:Pig122Rv	ACGGAAGTCTGAACCAGCCAAG	ACCTACGTATTACCGCGGCTGC
Pig20Fw:Pig123Rv	ACGGAAGTCTGAACCAGCCAAG	TCCTTATTCATGCGGTACCTGC
Pig20Fw:Pig124Rv	ACGGAAGTCTGAACCAGCCAAG	ATTAGCCGGTCCTTATTCATGC
Pig20Fw:Pig125Rv	ACGGAAGTCTGAACCAGCCAAG	GTCATCCTGCACGCTACTTGGC
Pig20Fw:Pig126Rv	ACGGAAGTCTGAACCAGCCAAG	AGCAGTTTACAACCCATAGGGC
Pig20Fw:Pig127Rv	ACGGAAGTCTGAACCAGCCAAG	CTCGCATCCTCCGTATTACCGC
Pig20Fw:Pig128Rv	ACGGAAGTCTGAACCAGCCAAG	CTTGCCACCTACGTATTACCGC
Pig20Fw:Pig129Rv	ACGGAAGTCTGAACCAGCCAAG	CTCGCCACCTACGTATTACCGC
Pig20Fw:Pig130Rv	ACGGAAGTCTGAACCAGCCAAG	TAATATCTACGCATTTCACCGC
Pig20Fw:Pig131Rv	ACGGAAGTCTGAACCAGCCAAG	TGATATCTAAGCATTTCACCGC
Pig20Fw:Pig132Rv	ACGGAAGTCTGAACCAGCCAAG	GTGTTCCTCCTAATATCTACGC
Pig20Fw:Pig133Rv	ACGGAAGTCTGAACCAGCCAAG	ACCCAGTAAATCCGGACAACGC
Pig20Fw:Pig134Rv	ACGGAAGTCTGAACCAGCCAAG	ACCCGCACTTTCGAGCTTCAGC
Pig20Fw:Pig135Rv	ACGGAAGTCTGAACCAGCCAAG	GAGTTCTTCGTGATATCTAAGC
Pig20Fw:Pig136Rv	ACGGAAGTCTGAACCAGCCAAG	TGGCTGGTTCAGACTTCCGTCC
Pig20Fw:Pig137Rv	ACGGAAGTCTGAACCAGCCAAG	TGGCTGGTTCAGACTTACGTCC
Pig20Fw:Pig138Rv	ACGGAAGTCTGAACCAGCCAAG	ACCACGAATTCCGCCTACCTCC
Pig20Fw:Pig139Rv	ACGGAAGTCTGAACCAGCCAAG	ACAACCCATAGGGCCGTCATCC
Pig20Fw:Pig140Rv	ACGGAAGTCTGAACCAGCCAAG	GCAGTTTACAACCCATAGGGCC
Pig20Fw:Pig141Rv	ACGGAAGTCTGAACCAGCCAAG	GGCCTACGCTCCCTTTAAACCC
Pig20Fw:Pig142Rv	ACGGAAGTCTGAACCAGCCAAG	CGCTCGCATCCTCCGTATTACC
Pig20Fw:Pig143Rv	ACGGAAGTCTGAACCAGCCAAG	CGCTTGCCACCTACGTATTACC
Pig20Fw:Pig144Rv	ACGGAAGTCTGAACCAGCCAAG	CGCTCGCCACCTACGTATTACC
Pig20Fw:Pig145Rv	ACGGAAGTCTGAACCAGCCAAG	TACACCACGAATTCCGCCTACC
Pig20Fw:Pig146Rv	ACGGAAGTCTGAACCAGCCAAG	TTCAGACTTCCGTCCATTGACC
Pig20Fw:Pig147Rv	ACGGAAGTCTGAACCAGCCAAG	TTCAGACTTACGTCCATTGACC
Pig20Fw:Pig148Rv	ACGGAAGTCTGAACCAGCCAAG	CCTAATATCTACGCATTTCACC
Pig20Fw:Pig149Rv	ACGGAAGTCTGAACCAGCCAAG	CGGCCTACGCTCCCTTTAAACC
Pig20Fw:Pig150Rv	ACGGAAGTCTGAACCAGCCAAG	ACGCTCGCATCCTCCGTATTAC
Pig20Fw:Pig151Rv	ACGGAAGTCTGAACCAGCCAAG	ACGCTTGCCACCTACGTATTAC
Pig20Fw:Pig152Rv	ACGGAAGTCTGAACCAGCCAAG	ACGCTCGCCACCTACGTATTAC
Pig20Fw:Pig153Rv	ACGGAAGTCTGAACCAGCCAAG	TGGTGTTCCTCCTAATATCTAC
Pig20Fw:Pig154Rv	ACGGAAGTCTGAACCAGCCAAG	TATCTATGCATTTCACCGCTAC
Pig20Fw:Pig155Rv	ACGGAAGTCTGAACCAGCCAAG	TATCTAAGCATTTCACCGCTAC
Pig20Fw:Pig156Rv	ACGGAAGTCTGAACCAGCCAAG	GTTCAGACTTCCGTCCATTGAC
Pig20Fw:Pig157Rv	ACGGAAGTCTGAACCAGCCAAG	GTTCAGACTTACGTCCATTGAC
Pig20Fw:Pig158Rv	ACGGAAGTCTGAACCAGCCAAG	ACGCTACTTGGCTGGTTCAGAC
Pig20Fw:Pig159Rv	ACGGAAGTCTGAACCAGCCAAG	TCTATGCATTTCACCGCTACAC
Pig20Fw:Pig160Rv	ACGGAAGTCTGAACCAGCCAAG	TCTAAGCATTTCACCGCTACAC
Pig20Fw:Pig161Rv	ACGGAAGTCTGAACCAGCCAAG	ACACCCAGTAAATCCGGACAAC
Pig20Fw:Pig162Rv	ACGGAAGTCTGAACCAGCCAAG	CCGGCCTACGCTCCCTTTAAAC
Pig20Fw:Pig163Rv	ACGGAAGTCTGAACCAGCCAAG	ACGGCCTACGCTCCCTTTAAAC
Pig20Fw:Pig164Rv	ACGGAAGTCTGAACCAGCCAAG	AAGCCGGCCTACGCTCCCTTTA
Pig20Fw:Pig165Rv	ACGGAAGTCTGAACCAGCCAAG	GCGGCATTTCACAACACGCTTA
Pig20Fw:Pig166Rv	ACGGAAGTCTGAACCAGCCAAG	GCACGGAATTAGCCGGTCCTTA
Pig20Fw:Pig167Rv	ACGGAAGTCTGAACCAGCCAAG	AACGCTCGCATCCTCCGTATTA
Pig20Fw:Pig168Rv	ACGGAAGTCTGAACCAGCCAAG	AACGCTTGCCACCTACGTATTA
Pig20Fw:Pig169Rv	ACGGAAGTCTGAACCAGCCAAG	AACGCTCGCCACCTACGTATTA
Pig20Fw:Pig170Rv	ACGGAAGTCTGAACCAGCCAAG	GATAACGCTCGCATCCTCCGTA
Pig20Fw:Pig171Rv	ACGGAAGTCTGAACCAGCCAAG	GACAACGCTTGCCACCTACGTA
Pig20Fw:Pig172Rv	ACGGAAGTCTGAACCAGCCAAG	TCGGAGTTCTTCGTGATATCTA
Pig20Fw:Pig173Rv	ACGGAAGTCTGAACCAGCCAAG	CTGGTGTTCCTCCTAATATCTA
Pig20Fw:Pig174Rv	ACGGAAGTCTGAACCAGCCAAG	ATATCTACGCATTTCACCGCTA
Pig20Fw:Pig175Rv	ACGGAAGTCTGAACCAGCCAAG	TTCGCCACTGGTGTTCCTCCTA
Pig20Fw:Pig176Rv	ACGGAAGTCTGAACCAGCCAAG	GCTACACCACGAATTCCGCCTA
Pig20Fw:Pig177Rv	ACGGAAGTCTGAACCAGCCAAG	TCCGGACAACGCTTGCCACCTA
Pig20Fw:Pig178Rv	ACGGAAGTCTGAACCAGCCAAG	TACGCATTTCACCGCTACACTA
Pig20Fw:Pig179Rv	ACGGAAGTCTGAACCAGCCAAG	GCAATCGGAGTTCTTCGTGATA
Pig20Fw:Pig180Rv	ACGGAAGTCTGAACCAGCCAAG	GCCACTGGTGTTCCTCCTAATA
Pig20Fw:Pig181Rv	ACGGAAGTCTGAACCAGCCAAG	TACGCTCCCTTTAAACCCAATA
Pig20Fw:Pig182Rv	ACGGAAGTCTGAACCAGCCAAG	GGTTCAGACTTCCGTCCATTGA
Pig20Fw:Pig183Rv	ACGGAAGTCTGAACCAGCCAAG	GGTTCAGACTTACGTCCATTGA
Pig20Fw:Pig184Rv	ACGGAAGTCTGAACCAGCCAAG	TCGCAATCGGAGTTCTTCGTGA
Pig20Fw:Pig185Rv	ACGGAAGTCTGAACCAGCCAAG	GTAAGCTGCCTTCGCAATCGGA
Pig20Fw:Pig186Rv	ACGGAAGTCTGAACCAGCCAAG	GCATTTCACCGCTACACTAGGA
Pig20Fw:Pig187Rv	ACGGAAGTCTGAACCAGCCAAG	CACGCTACTTGGCTGGTTCAGA
Pig20Fw:Pig188Rv	ACGGAAGTCTGAACCAGCCAAG	TGCACGCTACTTGGCTGGTTCA
Pig20Fw:Pig189Rv	ACGGAAGTCTGAACCAGCCAAG	ATACCCGCACTTTCGAGCTTCA
Pig20Fw:Pig190Rv	ACGGAAGTCTGAACCAGCCAAG	GCACTTTCGAGCTTCAGCGTCA
Pig20Fw:Pig191Rv	ACGGAAGTCTGAACCAGCCAAG	TTTACAACCCATAGGGCCGTCA
Pig20Fw:Pig192Rv	ACGGAAGTCTGAACCAGCCAAG	CCTTATTCATGCGGTACCTGCA
Pig20Fw:Pig193Rv	ACGGAAGTCTGAACCAGCCAAG	GCTACGGTAAGCTGCCTTCGCA
Pig20Fw:Pig194Rv	ACGGAAGTCTGAACCAGCCAAG	TGTTCCTCCTAATATCTACGCA
Pig20Fw:Pig195Rv	ACGGAAGTCTGAACCAGCCAAG	GGCTGGTTCAGACTTCCGTCCA
Pig20Fw:Pig196Rv	ACGGAAGTCTGAACCAGCCAAG	GGCTGGTTCAGACTTACGTCCA
Pig20Fw:Pig197Rv	ACGGAAGTCTGAACCAGCCAAG	GCCTACGCTCCCTTTAAACCCA
Pig20Fw:Pig198Rv	ACGGAAGTCTGAACCAGCCAAG	TCAGACTTCCGTCCATTGACCA
Pig20Fw:Pig199Rv	ACGGAAGTCTGAACCAGCCAAG	TCAGACTTACGTCCATTGACCA
Pig20Fw:Pig200Rv	ACGGAAGTCTGAACCAGCCAAG	ATCTATGCATTTCACCGCTACA
Pig20Fw:Pig201Rv	ACGGAAGTCTGAACCAGCCAAG	ATCTAAGCATTTCACCGCTACA
Pig20Fw:Pig202Rv	ACGGAAGTCTGAACCAGCCAAG	AGCCGGCCTACGCTCCCTTTAA
Pig20Fw:Pig203Rv	ACGGAAGTCTGAACCAGCCAAG	CGGCATTTCACAACACGCTTAA
Pig20Fw:Pig204Rv	ACGGAAGTCTGAACCAGCCAAG	CGGAGTTCTTCGTGATATCTAA
Pig20Fw:Pig205Rv	ACGGAAGTCTGAACCAGCCAAG	TCGCCACTGGTGTTCCTCCTAA
Pig20Fw:Pig206Rv	ACGGAAGTCTGAACCAGCCAAG	ACGCTCCCTTTAAACCCAATAA
Pig20Fw:Pig207Rv	ACGGAAGTCTGAACCAGCCAAG	CATTTCACCGCTACACTAGGAA
Pig20Fw:Pig208Rv	ACGGAAGTCTGAACCAGCCAAG	CTTATTCATGCGGTACCTGCAA
Pig20Fw:Pig209Rv	ACGGAAGTCTGAACCAGCCAAG	CTACGGTAAGCTGCCTTCGCAA
Pig20Fw:Pig210Rv	ACGGAAGTCTGAACCAGCCAAG	CCTACGCTCCCTTTAAACCCAA
Pig20Fw:Pig211Rv	ACGGAAGTCTGAACCAGCCAAG	CAGACTTCCGTCCATTGACCAA
Pig20Fw:Pig212Rv	ACGGAAGTCTGAACCAGCCAAG	CAGACTTACGTCCATTGACCAA
Pig20Fw:Pig213Rv	ACGGAAGTCTGAACCAGCCAAG	TACACCCAGTAAATCCGGACAA
Pig20Fw:Pig214Rv	ACGGAAGTCTGAACCAGCCAAG	GCCGGCCTACGCTCCCTTTAAA
Pig20Fw:Pig215Rv	ACGGAAGTCTGAACCAGCCAAG	GGCATTTCACAACACGCTTAAA
Pig20Fw:Pig216Rv	ACGGAAGTCTGAACCAGCCAAG	TTATTCATGCGGTACCTGCAAA
Pig20Fw:Pig217Rv	ACGGAAGTCTGAACCAGCCAAG	GCACGGAGTTAGCCGATGCTTT
Pig20Fw:Pig218Rv	ACGGAAGTCTGAACCAGCCAAG	CCTTCACGCGACTTGGCTGGTT
Pig20Fw:Pig219Rv	ACGGAAGTCTGAACCAGCCAAG	ACGGAGTTAGCCGATGCTTATT
Pig20Fw:Pig220Rv	ACGGAAGTCTGAACCAGCCAAG	CAACGCTCGCCACCTACGTATT
Pig20Fw:Pig221Rv	ACGGAAGTCTGAACCAGCCAAG	TTTCACCGCTACACAACGCATT
Pig20Fw:Pig222Rv	ACGGAAGTCTGAACCAGCCAAG	CTGGTTCAGGCTCTCGCCCATT
Pig20Fw:Pig223Rv	ACGGAAGTCTGAACCAGCCAAG	TTTCACCGCTACACGACGAATT
Pig20Fw:Pig224Rv	ACGGAAGTCTGAACCAGCCAAG	TCCTTCACGCGACTTGGCTGGT
Pig20Fw:Pig225Rv	ACGGAAGTCTGAACCAGCCAAG	ATCGGAGTTCTGCGTCATATCT
Pig20Fw:Pig226Rv	ACGGAAGTCTGAACCAGCCAAG	TCGTCCTGCACGCTACTTGGCT
Pig20Fw:Pig227Rv	ACGGAAGTCTGAACCAGCCAAG	CCCAGTAATTCCGGACAACGCT
Pig20Fw:Pig228Rv	ACGGAAGTCTGAACCAGCCAAG	ATCCGGACAACGCTTGCCACCT
Pig20Fw:Pig229Rv	ACGGAAGTCTGAACCAGCCAAG	CACGGAGTTAGCCGATGCTTAT
Pig20Fw:Pig230Rv	ACGGAAGTCTGAACCAGCCAAG	ACAACGCTCGCCACCTACGTAT
Pig20Fw:Pig231Rv	ACGGAAGTCTGAACCAGCCAAG	CGGAGTTCTGCGTCATATCTAT
Pig20Fw:Pig232Rv	ACGGAAGTCTGAACCAGCCAAG	CAATCGGAGTTCTGCGTCATAT
Pig20Fw:Pig233Rv	ACGGAAGTCTGAACCAGCCAAG	ATTTCACCGCTACACAACGCAT
Pig20Fw:Pig234Rv	ACGGAAGTCTGAACCAGCCAAG	ATTTCACCGCTACACGACGAAT
Pig20Fw:Pig235Rv	ACGGAAGTCTGAACCAGCCAAG	TGGTTCAGGCTCTCGCCCATTG
Pig20Fw:Pig236Rv	ACGGAAGTCTGAACCAGCCAAG	AAAGAGGTTTACAATCCGTAGG
Pig20Fw:Pig237Rv	ACGGAAGTCTGAACCAGCCAAG	CACGCTACTTGGCTGGTTCAGG
Pig20Fw:Pig238Rv	ACGGAAGTCTGAACCAGCCAAG	CACCGCTACACAACGCATTCCG
Pig20Fw:Pig239Rv	ACGGAAGTCTGAACCAGCCAAG	CCCTTTACGCCCAATAATTCCG
Pig20Fw:Pig240Rv	ACGGAAGTCTGAACCAGCCAAG	CACCGCTACACGACGAATTCCG
Pig20Fw:Pig241Rv	ACGGAAGTCTGAACCAGCCAAG	GTCATATCTAAGCATTTCACCG
Pig20Fw:Pig242Rv	ACGGAAGTCTGAACCAGCCAAG	AGCATTTCACCGCTACACGACG
Pig20Fw:Pig243Rv	ACGGAAGTCTGAACCAGCCAAG	CTAAGCATTTCACCGCTACACG
Pig20Fw:Pig244Rv	ACGGAAGTCTGAACCAGCCAAG	CACCCAGTAATTCCGGACAACG
Pig20Fw:Pig245Rv	ACGGAAGTCTGAACCAGCCAAG	TGCATTTCACCGCTACACAACG
Pig20Fw:Pig246Rv	ACGGAAGTCTGAACCAGCCAAG	CAAGCTGCCTTCGCAATCGGAG
Pig20Fw:Pig247Rv	ACGGAAGTCTGAACCAGCCAAG	CTTCACGCGACTTGGCTGGTTC
Pig20Fw:Pig248Rv	ACGGAAGTCTGAACCAGCCAAG	CGGAGTTAGCCGATGCTTATTC
Pig20Fw:Pig249Rv	ACGGAAGTCTGAACCAGCCAAG	TTCACCGCTACACAACGCATTC
Pig20Fw:Pig250Rv	ACGGAAGTCTGAACCAGCCAAG	TTCACCGCTACACGACGAATTC
Pig20Fw:Pig251Rv	ACGGAAGTCTGAACCAGCCAAG	AATCGGAGTTCTGCGTCATATC
Pig20Fw:Pig252Rv	ACGGAAGTCTGAACCAGCCAAG	ACGCTACTTGGCTGGTTCAGGC
Pig20Fw:Pig253Rv	ACGGAAGTCTGAACCAGCCAAG	TCATATCTAAGCATTTCACCGC
Pig20Fw:Pig254Rv	ACGGAAGTCTGAACCAGCCAAG	ACCCAGTAATTCCGGACAACGC
Pig20Fw:Pig255Rv	ACGGAAGTCTGAACCAGCCAAG	GCATTTCACCGCTACACAACGC
Pig20Fw:Pig256Rv	ACGGAAGTCTGAACCAGCCAAG	TCACCGCTACACAACGCATTCC
Pig20Fw:Pig257Rv	ACGGAAGTCTGAACCAGCCAAG	TCACCGCTACACGACGAATTCC
Pig20Fw:Pig258Rv	ACGGAAGTCTGAACCAGCCAAG	GTAAATCCGGACAACGCTTGCC
Pig20Fw:Pig259Rv	ACGGAAGTCTGAACCAGCCAAG	TTCAGGCTCTCGCCCATTGACC
Pig20Fw:Pig260Rv	ACGGAAGTCTGAACCAGCCAAG	GAGGTTTACAATCCGTAGGACC
Pig20Fw:Pig261Rv	ACGGAAGTCTGAACCAGCCAAG	CGTCATATCTAAGCATTTCACC
Pig20Fw:Pig262Rv	ACGGAAGTCTGAACCAGCCAAG	AATCCGGACAACGCTTGCCACC
Pig20Fw:Pig263Rv	ACGGAAGTCTGAACCAGCCAAG	CCGCCTACGCACCCTTTAAACC
Pig20Fw:Pig264Rv	ACGGAAGTCTGAACCAGCCAAG	GTTCAGGCTCTCGCCCATTGAC
Pig20Fw:Pig265Rv	ACGGAAGTCTGAACCAGCCAAG	AGAGGTTTACAATCCGTAGGAC
Pig20Fw:Pig266Rv	ACGGAAGTCTGAACCAGCCAAG	AAGCATTTCACCGCTACACGAC
Pig20Fw:Pig267Rv	ACGGAAGTCTGAACCAGCCAAG	AAATCCGGACAACGCTTGCCAC
Pig20Fw:Pig268Rv	ACGGAAGTCTGAACCAGCCAAG	AATTCCGGACAACGCTCGCCAC
Pig20Fw:Pig269Rv	ACGGAAGTCTGAACCAGCCAAG	ACACCCAGTAATTCCGGACAAC
Pig20Fw:Pig270Rv	ACGGAAGTCTGAACCAGCCAAG	ATGCATTTCACCGCTACACAAC
Pig20Fw:Pig271Rv	ACGGAAGTCTGAACCAGCCAAG	GCACGGAGTTAGCCGATGCTTA
Pig20Fw:Pig272Rv	ACGGAAGTCTGAACCAGCCAAG	GACAACGCTCGCCACCTACGTA
Pig20Fw:Pig273Rv	ACGGAAGTCTGAACCAGCCAAG	TCGGAGTTCTGCGTCATATCTA
Pig20Fw:Pig274Rv	ACGGAAGTCTGAACCAGCCAAG	GCAATCGGAGTTCTGCGTCATA
Pig20Fw:Pig275Rv	ACGGAAGTCTGAACCAGCCAAG	GGTTCAGGCTCTCGCCCATTGA
Pig20Fw:Pig276Rv	ACGGAAGTCTGAACCAGCCAAG	CTTTACGCCCAATAATTCCGGA
Pig20Fw:Pig277Rv	ACGGAAGTCTGAACCAGCCAAG	AAGAGGTTTACAATCCGTAGGA
Pig20Fw:Pig278Rv	ACGGAAGTCTGAACCAGCCAAG	GCATTTCACCGCTACACGACGA
Pig20Fw:Pig279Rv	ACGGAAGTCTGAACCAGCCAAG	TAAGCATTTCACCGCTACACGA
Pig20Fw:Pig280Rv	ACGGAAGTCTGAACCAGCCAAG	CTCACGCGACTTGGCTGGTTCA
Pig20Fw:Pig281Rv	ACGGAAGTCTGAACCAGCCAAG	CATTTCACCGCTACACAACGCA
Pig20Fw:Pig282Rv	ACGGAAGTCTGAACCAGCCAAG	TAAATCCGGACAACGCTTGCCA
Pig20Fw:Pig283Rv	ACGGAAGTCTGAACCAGCCAAG	TAATTCCGGACAACGCTCGCCA
Pig20Fw:Pig284Rv	ACGGAAGTCTGAACCAGCCAAG	TCAGGCTCTCGCCCATTGACCA
Pig20Fw:Pig285Rv	ACGGAAGTCTGAACCAGCCAAG	CTATGCATTTCACCGCTACACA
Pig20Fw:Pig286Rv	ACGGAAGTCTGAACCAGCCAAG	CATTTCACCGCTACACGACGAA
Pig20Fw:Pig287Rv	ACGGAAGTCTGAACCAGCCAAG	CAGGCTCTCGCCCATTGACCAA
Pig20Fw:Pig288Rv	ACGGAAGTCTGAACCAGCCAAG	TACACCCAGTAATTCCGGACAA
Pig20Fw:Pig289Rv	ACGGAAGTCTGAACCAGCCAAG	TATGCATTTCACCGCTACACAA
Pig23Fw:Pig1Rv	ACGTAAGTCTGAACCAGCCAAG	CCTGCACGCTACTTGGCTGGTT
Pig23Fw:Pig2Rv	ACGTAAGTCTGAACCAGCCAAG	AGCTGCCTTCGCAATCGGAGTT
Pig23Fw:Pig3Rv	ACGTAAGTCTGAACCAGCCAAG	TGCCTTCGCAATCGGAGTTCTT
Pig23Fw:Pig4Rv	ACGTAAGTCTGAACCAGCCAAG	GGCACGGAGTTAGCCGATGCTT
Pig23Fw:Pig5Rv	ACGTAAGTCTGAACCAGCCAAG	CGCGGCATTTCACAACACGCTT
Pig23Fw:Pig6Rv	ACGTAAGTCTGAACCAGCCAAG	CCAGTAAATCCGGACAACGCTT
Pig23Fw:Pig7Rv	ACGTAAGTCTGAACCAGCCAAG	CGATACCCGCACTTTCGAGCTT
Pig23Fw:Pig8Rv	ACGTAAGTCTGAACCAGCCAAG	GGCACGGAATTAGCCGGTCCTT
Pig23Fw:Pig9Rv	ACGTAAGTCTGAACCAGCCAAG	TAACGCTACGGTAAGCTGCCTT
Pig23Fw:Pig10Rv	ACGTAAGTCTGAACCAGCCAAG	GCCGTCATCCTGCACGCTACTT
Pig23Fw:Pig11Rv	ACGTAAGTCTGAACCAGCCAAG	ACGGAATTAGCCGGTCCTTATT
Pig23Fw:Pig12Rv	ACGTAAGTCTGAACCAGCCAAG	TAACGCTCGCATCCTCCGTATT
Pig23Fw:Pig13Rv	ACGTAAGTCTGAACCAGCCAAG	CAACGCTTGCCACCTACGTATT
Pig23Fw:Pig14Rv	ACGTAAGTCTGAACCAGCCAAG	CTGGTTCAGACTTCCGTCCATT
Pig23Fw:Pig15Rv	ACGTAAGTCTGAACCAGCCAAG	CTGGTTCAGACTTACGTCCATT
Pig23Fw:Pig16Rv	ACGTAAGTCTGAACCAGCCAAG	TTTCACCGCTACACTAGGAATT
Pig23Fw:Pig17Rv	ACGTAAGTCTGAACCAGCCAAG	TCCTGCACGCTACTTGGCTGGT
Pig23Fw:Pig18Rv	ACGTAAGTCTGAACCAGCCAAG	TGCTGGCACGGAATTAGCCGGT
Pig23Fw:Pig19Rv	ACGTAAGTCTGAACCAGCCAAG	CCGCACTTTCGAGCTTCAGCGT
Pig23Fw:Pig20Rv	ACGTAAGTCTGAACCAGCCAAG	CTTGGCTGGTTCAGACTTCCGT
Pig23Fw:Pig21Rv	ACGTAAGTCTGAACCAGCCAAG	AGTTTACAACCCATAGGGCCGT
Pig23Fw:Pig22Rv	ACGTAAGTCTGAACCAGCCAAG	CTGCTGGCACGTAGTTAGCCGT
Pig23Fw:Pig23Rv	ACGTAAGTCTGAACCAGCCAAG	CTTGGCTGGTTCAGACTTACGT
Pig23Fw:Pig24Rv	ACGTAAGTCTGAACCAGCCAAG	GGACAACGCTTGCCACCTACGT
Pig23Fw:Pig25Rv	ACGTAAGTCTGAACCAGCCAAG	AAGCTGCCTTCGCAATCGGAGT
Pig23Fw:Pig26Rv	ACGTAAGTCTGAACCAGCCAAG	CTGCCTTCGCAATCGGAGTTCT
Pig23Fw:Pig27Rv	ACGTAAGTCTGAACCAGCCAAG	ATCGGAGTTCTTCGTGATATCT
Pig23Fw:Pig28Rv	ACGTAAGTCTGAACCAGCCAAG	ACTGGTGTTCCTCCTAATATCT
Pig23Fw:Pig29Rv	ACGTAAGTCTGAACCAGCCAAG	CTTCCGTATTACCGCGGCTGCT
Pig23Fw:Pig30Rv	ACGTAAGTCTGAACCAGCCAAG	CCTACGTATTACCGCGGCTGCT
Pig23Fw:Pig31Rv	ACGTAAGTCTGAACCAGCCAAG	TGGCACGGAGTTAGCCGATGCT
Pig23Fw:Pig32Rv	ACGTAAGTCTGAACCAGCCAAG	TCATCCTGCACGCTACTTGGCT
Pig23Fw:Pig33Rv	ACGTAAGTCTGAACCAGCCAAG	GACCTTCCGTATTACCGCGGCT
Pig23Fw:Pig34Rv	ACGTAAGTCTGAACCAGCCAAG	CATCCTCCGTATTACCGCGGCT
Pig23Fw:Pig35Rv	ACGTAAGTCTGAACCAGCCAAG	CCACCTACGTATTACCGCGGCT
Pig23Fw:Pig36Rv	ACGTAAGTCTGAACCAGCCAAG	AATATCTACGCATTTCACCGCT
Pig23Fw:Pig37Rv	ACGTAAGTCTGAACCAGCCAAG	GATATCTAAGCATTTCACCGCT
Pig23Fw:Pig38Rv	ACGTAAGTCTGAACCAGCCAAG	CATATCTAAGCATTTCACCGCT
Pig23Fw:Pig39Rv	ACGTAAGTCTGAACCAGCCAAG	CCGCGGCATTTCACAACACGCT
Pig23Fw:Pig40Rv	ACGTAAGTCTGAACCAGCCAAG	CCCAGTAAATCCGGACAACGCT
Pig23Fw:Pig41Rv	ACGTAAGTCTGAACCAGCCAAG	TGGCACGGAATTAGCCGGTCCT
Pig23Fw:Pig42Rv	ACGTAAGTCTGAACCAGCCAAG	CTTCGCCACTGGTGTTCCTCCT
Pig23Fw:Pig43Rv	ACGTAAGTCTGAACCAGCCAAG	CAACCCATAGGGCCGTCATCCT
Pig23Fw:Pig44Rv	ACGTAAGTCTGAACCAGCCAAG	CGCTACACCACGAATTCCGCCT
Pig23Fw:Pig45Rv	ACGTAAGTCTGAACCAGCCAAG	GGTCCTTATTCATGCGGTACCT
Pig23Fw:Pig46Rv	ACGTAAGTCTGAACCAGCCAAG	ACACCACGAATTCCGCCTACCT
Pig23Fw:Pig47Rv	ACGTAAGTCTGAACCAGCCAAG	CGCTACTTGGCTGGTTCAGACT
Pig23Fw:Pig48Rv	ACGTAAGTCTGAACCAGCCAAG	CACGGAATTAGCCGGTCCTTAT
Pig23Fw:Pig49Rv	ACGTAAGTCTGAACCAGCCAAG	ATAACGCTCGCATCCTCCGTAT
Pig23Fw:Pig50Rv	ACGTAAGTCTGAACCAGCCAAG	ACAACGCTTGCCACCTACGTAT
Pig23Fw:Pig51Rv	ACGTAAGTCTGAACCAGCCAAG	CAATCGGAGTTCTTCGTGATAT
Pig23Fw:Pig52Rv	ACGTAAGTCTGAACCAGCCAAG	CCACTGGTGTTCCTCCTAATAT
Pig23Fw:Pig53Rv	ACGTAAGTCTGAACCAGCCAAG	CGCAATCGGAGTTCTTCGTGAT
Pig23Fw:Pig54Rv	ACGTAAGTCTGAACCAGCCAAG	TGCTGGCACGGAGTTAGCCGAT
Pig23Fw:Pig55Rv	ACGTAAGTCTGAACCAGCCAAG	TTACAACCCATAGGGCCGTCAT
Pig23Fw:Pig56Rv	ACGTAAGTCTGAACCAGCCAAG	GTTCCTCCTAATATCTACGCAT
Pig23Fw:Pig57Rv	ACGTAAGTCTGAACCAGCCAAG	GCTGGTTCAGACTTCCGTCCAT
Pig23Fw:Pig58Rv	ACGTAAGTCTGAACCAGCCAAG	GCTGGTTCAGACTTACGTCCAT
Pig23Fw:Pig59Rv	ACGTAAGTCTGAACCAGCCAAG	CGCCACTGGTGTTCCTCCTAAT
Pig23Fw:Pig60Rv	ACGTAAGTCTGAACCAGCCAAG	ATTTCACCGCTACACTAGGAAT
Pig23Fw:Pig61Rv	ACGTAAGTCTGAACCAGCCAAG	TACGGTAAGCTGCCTTCGCAAT
Pig23Fw:Pig62Rv	ACGTAAGTCTGAACCAGCCAAG	CTACGCTCCCTTTAAACCCAAT
Pig23Fw:Pig63Rv	ACGTAAGTCTGAACCAGCCAAG	CAGTAAATCCGGACAACGCTTG
Pig23Fw:Pig64Rv	ACGTAAGTCTGAACCAGCCAAG	CCGTCATCCTGCACGCTACTTG
Pig23Fw:Pig65Rv	ACGTAAGTCTGAACCAGCCAAG	TGGTTCAGACTTCCGTCCATTG
Pig23Fw:Pig66Rv	ACGTAAGTCTGAACCAGCCAAG	TGGTTCAGACTTACGTCCATTG
Pig23Fw:Pig67Rv	ACGTAAGTCTGAACCAGCCAAG	TGCCTTCGCAATCGGAGTTCTG
Pig23Fw:Pig68Rv	ACGTAAGTCTGAACCAGCCAAG	TTCCGTATTACCGCGGCTGCTG
Pig23Fw:Pig69Rv	ACGTAAGTCTGAACCAGCCAAG	CTACGTATTACCGCGGCTGCTG
Pig23Fw:Pig70Rv	ACGTAAGTCTGAACCAGCCAAG	CATCCTGCACGCTACTTGGCTG
Pig23Fw:Pig71Rv	ACGTAAGTCTGAACCAGCCAAG	ACCTTCCGTATTACCGCGGCTG
Pig23Fw:Pig72Rv	ACGTAAGTCTGAACCAGCCAAG	ATCCTCCGTATTACCGCGGCTG
Pig23Fw:Pig73Rv	ACGTAAGTCTGAACCAGCCAAG	CACCTACGTATTACCGCGGCTG
Pig23Fw:Pig74Rv	ACGTAAGTCTGAACCAGCCAAG	AACCCATAGGGCCGTCATCCTG
Pig23Fw:Pig75Rv	ACGTAAGTCTGAACCAGCCAAG	GTCCTTATTCATGCGGTACCTG
Pig23Fw:Pig76Rv	ACGTAAGTCTGAACCAGCCAAG	AATTAGCCGGTCCTTATTCATG
Pig23Fw:Pig77Rv	ACGTAAGTCTGAACCAGCCAAG	CGTCATCCTGCACGCTACTTGG
Pig23Fw:Pig78Rv	ACGTAAGTCTGAACCAGCCAAG	TACGTATTACCGCGGCTGCTGG
Pig23Fw:Pig79Rv	ACGTAAGTCTGAACCAGCCAAG	ATCCTGCACGCTACTTGGCTGG
Pig23Fw:Pig80Rv	ACGTAAGTCTGAACCAGCCAAG	AAGCAGTTTACAACCCATAGGG
Pig23Fw:Pig81Rv	ACGTAAGTCTGAACCAGCCAAG	GGTAAGCTGCCTTCGCAATCGG
Pig23Fw:Pig82Rv	ACGTAAGTCTGAACCAGCCAAG	TAGCCGGTCCTTATTCATGCGG
Pig23Fw:Pig83Rv	ACGTAAGTCTGAACCAGCCAAG	TGCCACCTACGTATTACCGCGG
Pig23Fw:Pig84Rv	ACGTAAGTCTGAACCAGCCAAG	CGCATTTCACCGCTACACTAGG
Pig23Fw:Pig85Rv	ACGTAAGTCTGAACCAGCCAAG	AAAGCAGTTTACAACCCATAGG
Pig23Fw:Pig86Rv	ACGTAAGTCTGAACCAGCCAAG	ACGCTACGGTAAGCTGCCTTCG
Pig23Fw:Pig87Rv	ACGTAAGTCTGAACCAGCCAAG	CGGTAAGCTGCCTTCGCAATCG
Pig23Fw:Pig88Rv	ACGTAAGTCTGAACCAGCCAAG	TTAGCCGGTCCTTATTCATGCG
Pig23Fw:Pig89Rv	ACGTAAGTCTGAACCAGCCAAG	TCGCATCCTCCGTATTACCGCG
Pig23Fw:Pig90Rv	ACGTAAGTCTGAACCAGCCAAG	TTGCCACCTACGTATTACCGCG
Pig23Fw:Pig91Rv	ACGTAAGTCTGAACCAGCCAAG	TCGCCACCTACGTATTACCGCG
Pig23Fw:Pig92Rv	ACGTAAGTCTGAACCAGCCAAG	CAGTTTACAACCCATAGGGCCG
Pig23Fw:Pig93Rv	ACGTAAGTCTGAACCAGCCAAG	GCTCGCATCCTCCGTATTACCG
Pig23Fw:Pig94Rv	ACGTAAGTCTGAACCAGCCAAG	GCTTGCCACCTACGTATTACCG
Pig23Fw:Pig95Rv	ACGTAAGTCTGAACCAGCCAAG	GCTCGCCACCTACGTATTACCG
Pig23Fw:Pig96Rv	ACGTAAGTCTGAACCAGCCAAG	CTAATATCTACGCATTTCACCG
Pig23Fw:Pig97Rv	ACGTAAGTCTGAACCAGCCAAG	GGTGTTCCTCCTAATATCTACG
Pig23Fw:Pig98Rv	ACGTAAGTCTGAACCAGCCAAG	CACCCAGTAAATCCGGACAACG
Pig23Fw:Pig99Rv	ACGTAAGTCTGAACCAGCCAAG	ACGCATTTCACCGCTACACTAG
Pig23Fw:Pig100Rv	ACGTAAGTCTGAACCAGCCAAG	TAAGCTGCCTTCGCAATCGGAG
Pig23Fw:Pig101Rv	ACGTAAGTCTGAACCAGCCAAG	GCACGCTACTTGGCTGGTTCAG
Pig23Fw:Pig102Rv	ACGTAAGTCTGAACCAGCCAAG	TCACGCGACTTGGCTGGTTCAG
Pig23Fw:Pig103Rv	ACGTAAGTCTGAACCAGCCAAG	TACCCGCACTTTCGAGCTTCAG
Pig23Fw:Pig104Rv	ACGTAAGTCTGAACCAGCCAAG	GGAGTTCTTCGTGATATCTAAG
Pig23Fw:Pig105Rv	ACGTAAGTCTGAACCAGCCAAG	CCTCCTAATATCTACGCATTTC
Pig23Fw:Pig106Rv	ACGTAAGTCTGAACCAGCCAAG	CTGCACGCTACTTGGCTGGTTC
Pig23Fw:Pig107Rv	ACGTAAGTCTGAACCAGCCAAG	GCTGCCTTCGCAATCGGAGTTC
Pig23Fw:Pig108Rv	ACGTAAGTCTGAACCAGCCAAG	GATACCCGCACTTTCGAGCTTC
Pig23Fw:Pig109Rv	ACGTAAGTCTGAACCAGCCAAG	AACGCTACGGTAAGCTGCCTTC
Pig23Fw:Pig110Rv	ACGTAAGTCTGAACCAGCCAAG	TTCACCGCTACACTAGGAATTC
Pig23Fw:Pig111Rv	ACGTAAGTCTGAACCAGCCAAG	CGCACTTTCGAGCTTCAGCGTC
Pig23Fw:Pig112Rv	ACGTAAGTCTGAACCAGCCAAG	TTGGCTGGTTCAGACTTCCGTC
Pig23Fw:Pig113Rv	ACGTAAGTCTGAACCAGCCAAG	GTTTACAACCCATAGGGCCGTC
Pig23Fw:Pig114Rv	ACGTAAGTCTGAACCAGCCAAG	TTGGCTGGTTCAGACTTACGTC
Pig23Fw:Pig115Rv	ACGTAAGTCTGAACCAGCCAAG	CACCACGAATTCCGCCTACCTC
Pig23Fw:Pig116Rv	ACGTAAGTCTGAACCAGCCAAG	AATCGGAGTTCTTCGTGATATC
Pig23Fw:Pig117Rv	ACGTAAGTCTGAACCAGCCAAG	CACTGGTGTTCCTCCTAATATC
Pig23Fw:Pig118Rv	ACGTAAGTCTGAACCAGCCAAG	TACAACCCATAGGGCCGTCATC
Pig23Fw:Pig119Rv	ACGTAAGTCTGAACCAGCCAAG	ACGGTAAGCTGCCTTCGCAATC
Pig23Fw:Pig120Rv	ACGTAAGTCTGAACCAGCCAAG	AGTAAATCCGGACAACGCTTGC
Pig23Fw:Pig121Rv	ACGTAAGTCTGAACCAGCCAAG	GCCTTCGCAATCGGAGTTCTGC
Pig23Fw:Pig122Rv	ACGTAAGTCTGAACCAGCCAAG	ACCTACGTATTACCGCGGCTGC
Pig23Fw:Pig123Rv	ACGTAAGTCTGAACCAGCCAAG	TCCTTATTCATGCGGTACCTGC
Pig23Fw:Pig124Rv	ACGTAAGTCTGAACCAGCCAAG	ATTAGCCGGTCCTTATTCATGC
Pig23Fw:Pig125Rv	ACGTAAGTCTGAACCAGCCAAG	GTCATCCTGCACGCTACTTGGC
Pig23Fw:Pig126Rv	ACGTAAGTCTGAACCAGCCAAG	AGCAGTTTACAACCCATAGGGC
Pig23Fw:Pig127Rv	ACGTAAGTCTGAACCAGCCAAG	CTCGCATCCTCCGTATTACCGC
Pig23Fw:Pig128Rv	ACGTAAGTCTGAACCAGCCAAG	CTTGCCACCTACGTATTACCGC
Pig23Fw:Pig129Rv	ACGTAAGTCTGAACCAGCCAAG	CTCGCCACCTACGTATTACCGC
Pig23Fw:Pig130Rv	ACGTAAGTCTGAACCAGCCAAG	TAATATCTACGCATTTCACCGC
Pig23Fw:Pig131Rv	ACGTAAGTCTGAACCAGCCAAG	TGATATCTAAGCATTTCACCGC
Pig23Fw:Pig132Rv	ACGTAAGTCTGAACCAGCCAAG	GTGTTCCTCCTAATATCTACGC
Pig23Fw:Pig133Rv	ACGTAAGTCTGAACCAGCCAAG	ACCCAGTAAATCCGGACAACGC
Pig23Fw:Pig134Rv	ACGTAAGTCTGAACCAGCCAAG	ACCCGCACTTTCGAGCTTCAGC
Pig23Fw:Pig135Rv	ACGTAAGTCTGAACCAGCCAAG	GAGTTCTTCGTGATATCTAAGC
Pig23Fw:Pig136Rv	ACGTAAGTCTGAACCAGCCAAG	TGGCTGGTTCAGACTTCCGTCC
Pig23Fw:Pig137Rv	ACGTAAGTCTGAACCAGCCAAG	TGGCTGGTTCAGACTTACGTCC
Pig23Fw:Pig138Rv	ACGTAAGTCTGAACCAGCCAAG	ACCACGAATTCCGCCTACCTCC
Pig23Fw:Pig139Rv	ACGTAAGTCTGAACCAGCCAAG	ACAACCCATAGGGCCGTCATCC
Pig23Fw:Pig140Rv	ACGTAAGTCTGAACCAGCCAAG	GCAGTTTACAACCCATAGGGCC
Pig23Fw:Pig141Rv	ACGTAAGTCTGAACCAGCCAAG	GGCCTACGCTCCCTTTAAACCC
Pig23Fw:Pig142Rv	ACGTAAGTCTGAACCAGCCAAG	CGCTCGCATCCTCCGTATTACC
Pig23Fw:Pig143Rv	ACGTAAGTCTGAACCAGCCAAG	CGCTTGCCACCTACGTATTACC
Pig23Fw:Pig144Rv	ACGTAAGTCTGAACCAGCCAAG	CGCTCGCCACCTACGTATTACC
Pig23Fw:Pig145Rv	ACGTAAGTCTGAACCAGCCAAG	TACACCACGAATTCCGCCTACC
Pig23Fw:Pig146Rv	ACGTAAGTCTGAACCAGCCAAG	TTCAGACTTCCGTCCATTGACC
Pig23Fw:Pig147Rv	ACGTAAGTCTGAACCAGCCAAG	TTCAGACTTACGTCCATTGACC
Pig23Fw:Pig148Rv	ACGTAAGTCTGAACCAGCCAAG	CCTAATATCTACGCATTTCACC
Pig23Fw:Pig149Rv	ACGTAAGTCTGAACCAGCCAAG	CGGCCTACGCTCCCTTTAAACC
Pig23Fw:Pig150Rv	ACGTAAGTCTGAACCAGCCAAG	ACGCTCGCATCCTCCGTATTAC
Pig23Fw:Pig151Rv	ACGTAAGTCTGAACCAGCCAAG	ACGCTTGCCACCTACGTATTAC
Pig23Fw:Pig152Rv	ACGTAAGTCTGAACCAGCCAAG	ACGCTCGCCACCTACGTATTAC
Pig23Fw:Pig153Rv	ACGTAAGTCTGAACCAGCCAAG	TGGTGTTCCTCCTAATATCTAC
Pig23Fw:Pig154Rv	ACGTAAGTCTGAACCAGCCAAG	TATCTATGCATTTCACCGCTAC
Pig23Fw:Pig155Rv	ACGTAAGTCTGAACCAGCCAAG	TATCTAAGCATTTCACCGCTAC
Pig23Fw:Pig156Rv	ACGTAAGTCTGAACCAGCCAAG	GTTCAGACTTCCGTCCATTGAC
Pig23Fw:Pig157Rv	ACGTAAGTCTGAACCAGCCAAG	GTTCAGACTTACGTCCATTGAC
Pig23Fw:Pig158Rv	ACGTAAGTCTGAACCAGCCAAG	ACGCTACTTGGCTGGTTCAGAC
Pig23Fw:Pig159Rv	ACGTAAGTCTGAACCAGCCAAG	TCTATGCATTTCACCGCTACAC
Pig23Fw:Pig160Rv	ACGTAAGTCTGAACCAGCCAAG	TCTAAGCATTTCACCGCTACAC
Pig23Fw:Pig161Rv	ACGTAAGTCTGAACCAGCCAAG	ACACCCAGTAAATCCGGACAAC
Pig23Fw:Pig162Rv	ACGTAAGTCTGAACCAGCCAAG	CCGGCCTACGCTCCCTTTAAAC
Pig23Fw:Pig163Rv	ACGTAAGTCTGAACCAGCCAAG	ACGGCCTACGCTCCCTTTAAAC
Pig23Fw:Pig164Rv	ACGTAAGTCTGAACCAGCCAAG	AAGCCGGCCTACGCTCCCTTTA
Pig23Fw:Pig165Rv	ACGTAAGTCTGAACCAGCCAAG	GCGGCATTTCACAACACGCTTA
Pig23Fw:Pig166Rv	ACGTAAGTCTGAACCAGCCAAG	GCACGGAATTAGCCGGTCCTTA
Pig23Fw:Pig167Rv	ACGTAAGTCTGAACCAGCCAAG	AACGCTCGCATCCTCCGTATTA
Pig23Fw:Pig168Rv	ACGTAAGTCTGAACCAGCCAAG	AACGCTTGCCACCTACGTATTA
Pig23Fw:Pig169Rv	ACGTAAGTCTGAACCAGCCAAG	AACGCTCGCCACCTACGTATTA
Pig23Fw:Pig170Rv	ACGTAAGTCTGAACCAGCCAAG	GATAACGCTCGCATCCTCCGTA
Pig23Fw:Pig171Rv	ACGTAAGTCTGAACCAGCCAAG	GACAACGCTTGCCACCTACGTA
Pig23Fw:Pig172Rv	ACGTAAGTCTGAACCAGCCAAG	TCGGAGTTCTTCGTGATATCTA
Pig23Fw:Pig173Rv	ACGTAAGTCTGAACCAGCCAAG	CTGGTGTTCCTCCTAATATCTA
Pig23Fw:Pig174Rv	ACGTAAGTCTGAACCAGCCAAG	ATATCTACGCATTTCACCGCTA
Pig23Fw:Pig175Rv	ACGTAAGTCTGAACCAGCCAAG	TTCGCCACTGGTGTTCCTCCTA
Pig23Fw:Pig176Rv	ACGTAAGTCTGAACCAGCCAAG	GCTACACCACGAATTCCGCCTA
Pig23Fw:Pig177Rv	ACGTAAGTCTGAACCAGCCAAG	TCCGGACAACGCTTGCCACCTA
Pig23Fw:Pig178Rv	ACGTAAGTCTGAACCAGCCAAG	TACGCATTTCACCGCTACACTA
Pig23Fw:Pig179Rv	ACGTAAGTCTGAACCAGCCAAG	GCAATCGGAGTTCTTCGTGATA
Pig23Fw:Pig180Rv	ACGTAAGTCTGAACCAGCCAAG	GCCACTGGTGTTCCTCCTAATA
Pig23Fw:Pig181Rv	ACGTAAGTCTGAACCAGCCAAG	TACGCTCCCTTTAAACCCAATA
Pig23Fw:Pig182Rv	ACGTAAGTCTGAACCAGCCAAG	GGTTCAGACTTCCGTCCATTGA
Pig23Fw:Pig183Rv	ACGTAAGTCTGAACCAGCCAAG	GGTTCAGACTTACGTCCATTGA
Pig23Fw:Pig184Rv	ACGTAAGTCTGAACCAGCCAAG	TCGCAATCGGAGTTCTTCGTGA
Pig23Fw:Pig185Rv	ACGTAAGTCTGAACCAGCCAAG	GTAAGCTGCCTTCGCAATCGGA
Pig23Fw:Pig186Rv	ACGTAAGTCTGAACCAGCCAAG	GCATTTCACCGCTACACTAGGA
Pig23Fw:Pig187Rv	ACGTAAGTCTGAACCAGCCAAG	CACGCTACTTGGCTGGTTCAGA
Pig23Fw:Pig188Rv	ACGTAAGTCTGAACCAGCCAAG	TGCACGCTACTTGGCTGGTTCA
Pig23Fw:Pig189Rv	ACGTAAGTCTGAACCAGCCAAG	ATACCCGCACTTTCGAGCTTCA
Pig23Fw:Pig190Rv	ACGTAAGTCTGAACCAGCCAAG	GCACTTTCGAGCTTCAGCGTCA
Pig23Fw:Pig191Rv	ACGTAAGTCTGAACCAGCCAAG	TTTACAACCCATAGGGCCGTCA
Pig23Fw:Pig192Rv	ACGTAAGTCTGAACCAGCCAAG	CCTTATTCATGCGGTACCTGCA
Pig23Fw:Pig193Rv	ACGTAAGTCTGAACCAGCCAAG	GCTACGGTAAGCTGCCTTCGCA
Pig23Fw:Pig194Rv	ACGTAAGTCTGAACCAGCCAAG	TGTTCCTCCTAATATCTACGCA
Pig23Fw:Pig195Rv	ACGTAAGTCTGAACCAGCCAAG	GGCTGGTTCAGACTTCCGTCCA
Pig23Fw:Pig196Rv	ACGTAAGTCTGAACCAGCCAAG	GGCTGGTTCAGACTTACGTCCA
Pig23Fw:Pig197Rv	ACGTAAGTCTGAACCAGCCAAG	GCCTACGCTCCCTTTAAACCCA
Pig23Fw:Pig198Rv	ACGTAAGTCTGAACCAGCCAAG	TCAGACTTCCGTCCATTGACCA
Pig23Fw:Pig199Rv	ACGTAAGTCTGAACCAGCCAAG	TCAGACTTACGTCCATTGACCA
Pig23Fw:Pig200Rv	ACGTAAGTCTGAACCAGCCAAG	ATCTATGCATTTCACCGCTACA
Pig23Fw:Pig201Rv	ACGTAAGTCTGAACCAGCCAAG	ATCTAAGCATTTCACCGCTACA
Pig23Fw:Pig202Rv	ACGTAAGTCTGAACCAGCCAAG	AGCCGGCCTACGCTCCCTTTAA
Pig23Fw:Pig203Rv	ACGTAAGTCTGAACCAGCCAAG	CGGCATTTCACAACACGCTTAA
Pig23Fw:Pig204Rv	ACGTAAGTCTGAACCAGCCAAG	CGGAGTTCTTCGTGATATCTAA
Pig23Fw:Pig205Rv	ACGTAAGTCTGAACCAGCCAAG	TCGCCACTGGTGTTCCTCCTAA
Pig23Fw:Pig206Rv	ACGTAAGTCTGAACCAGCCAAG	ACGCTCCCTTTAAACCCAATAA
Pig23Fw:Pig207Rv	ACGTAAGTCTGAACCAGCCAAG	CATTTCACCGCTACACTAGGAA
Pig23Fw:Pig208Rv	ACGTAAGTCTGAACCAGCCAAG	CTTATTCATGCGGTACCTGCAA
Pig23Fw:Pig209Rv	ACGTAAGTCTGAACCAGCCAAG	CTACGGTAAGCTGCCTTCGCAA
Pig23Fw:Pig210Rv	ACGTAAGTCTGAACCAGCCAAG	CCTACGCTCCCTTTAAACCCAA
Pig23Fw:Pig211Rv	ACGTAAGTCTGAACCAGCCAAG	CAGACTTCCGTCCATTGACCAA
Pig23Fw:Pig212Rv	ACGTAAGTCTGAACCAGCCAAG	CAGACTTACGTCCATTGACCAA
Pig23Fw:Pig213Rv	ACGTAAGTCTGAACCAGCCAAG	TACACCCAGTAAATCCGGACAA
Pig23Fw:Pig214Rv	ACGTAAGTCTGAACCAGCCAAG	GCCGGCCTACGCTCCCTTTAAA
Pig23Fw:Pig215Rv	ACGTAAGTCTGAACCAGCCAAG	GGCATTTCACAACACGCTTAAA
Pig23Fw:Pig216Rv	ACGTAAGTCTGAACCAGCCAAG	TTATTCATGCGGTACCTGCAAA
Pig23Fw:Pig217Rv	ACGTAAGTCTGAACCAGCCAAG	GCACGGAGTTAGCCGATGCTTT
Pig23Fw:Pig218Rv	ACGTAAGTCTGAACCAGCCAAG	CCTTCACGCGACTTGGCTGGTT
Pig23Fw:Pig219Rv	ACGTAAGTCTGAACCAGCCAAG	ACGGAGTTAGCCGATGCTTATT
Pig23Fw:Pig220Rv	ACGTAAGTCTGAACCAGCCAAG	CAACGCTCGCCACCTACGTATT
Pig23Fw:Pig221Rv	ACGTAAGTCTGAACCAGCCAAG	TTTCACCGCTACACAACGCATT
Pig23Fw:Pig222Rv	ACGTAAGTCTGAACCAGCCAAG	CTGGTTCAGGCTCTCGCCCATT
Pig23Fw:Pig223Rv	ACGTAAGTCTGAACCAGCCAAG	TTTCACCGCTACACGACGAATT
Pig23Fw:Pig224Rv	ACGTAAGTCTGAACCAGCCAAG	TCCTTCACGCGACTTGGCTGGT
Pig23Fw:Pig225Rv	ACGTAAGTCTGAACCAGCCAAG	ATCGGAGTTCTGCGTCATATCT
Pig23Fw:Pig226Rv	ACGTAAGTCTGAACCAGCCAAG	TCGTCCTGCACGCTACTTGGCT
Pig23Fw:Pig227Rv	ACGTAAGTCTGAACCAGCCAAG	CCCAGTAATTCCGGACAACGCT
Pig23Fw:Pig228Rv	ACGTAAGTCTGAACCAGCCAAG	ATCCGGACAACGCTTGCCACCT
Pig23Fw:Pig229Rv	ACGTAAGTCTGAACCAGCCAAG	CACGGAGTTAGCCGATGCTTAT
Pig23Fw:Pig230Rv	ACGTAAGTCTGAACCAGCCAAG	ACAACGCTCGCCACCTACGTAT
Pig23Fw:Pig231Rv	ACGTAAGTCTGAACCAGCCAAG	CGGAGTTCTGCGTCATATCTAT
Pig23Fw:Pig232Rv	ACGTAAGTCTGAACCAGCCAAG	CAATCGGAGTTCTGCGTCATAT
Pig23Fw:Pig233Rv	ACGTAAGTCTGAACCAGCCAAG	ATTTCACCGCTACACAACGCAT
Pig23Fw:Pig234Rv	ACGTAAGTCTGAACCAGCCAAG	ATTTCACCGCTACACGACGAAT
Pig23Fw:Pig235Rv	ACGTAAGTCTGAACCAGCCAAG	TGGTTCAGGCTCTCGCCCATTG
Pig23Fw:Pig236Rv	ACGTAAGTCTGAACCAGCCAAG	AAAGAGGTTTACAATCCGTAGG
Pig23Fw:Pig237Rv	ACGTAAGTCTGAACCAGCCAAG	CACGCTACTTGGCTGGTTCAGG
Pig23Fw:Pig238Rv	ACGTAAGTCTGAACCAGCCAAG	CACCGCTACACAACGCATTCCG
Pig23Fw:Pig239Rv	ACGTAAGTCTGAACCAGCCAAG	CCCTTTACGCCCAATAATTCCG
Pig23Fw:Pig240Rv	ACGTAAGTCTGAACCAGCCAAG	CACCGCTACACGACGAATTCCG
Pig23Fw:Pig241Rv	ACGTAAGTCTGAACCAGCCAAG	GTCATATCTAAGCATTTCACCG
Pig23Fw:Pig242Rv	ACGTAAGTCTGAACCAGCCAAG	AGCATTTCACCGCTACACGACG
Pig23Fw:Pig243Rv	ACGTAAGTCTGAACCAGCCAAG	CTAAGCATTTCACCGCTACACG
Pig23Fw:Pig244Rv	ACGTAAGTCTGAACCAGCCAAG	CACCCAGTAATTCCGGACAACG
Pig23Fw:Pig245Rv	ACGTAAGTCTGAACCAGCCAAG	TGCATTTCACCGCTACACAACG
Pig23Fw:Pig246Rv	ACGTAAGTCTGAACCAGCCAAG	CAAGCTGCCTTCGCAATCGGAG
Pig23Fw:Pig247Rv	ACGTAAGTCTGAACCAGCCAAG	CTTCACGCGACTTGGCTGGTTC
Pig23Fw:Pig248Rv	ACGTAAGTCTGAACCAGCCAAG	CGGAGTTAGCCGATGCTTATTC
Pig23Fw:Pig249Rv	ACGTAAGTCTGAACCAGCCAAG	TTCACCGCTACACAACGCATTC
Pig23Fw:Pig250Rv	ACGTAAGTCTGAACCAGCCAAG	TTCACCGCTACACGACGAATTC
Pig23Fw:Pig251Rv	ACGTAAGTCTGAACCAGCCAAG	AATCGGAGTTCTGCGTCATATC
Pig23Fw:Pig252Rv	ACGTAAGTCTGAACCAGCCAAG	ACGCTACTTGGCTGGTTCAGGC
Pig23Fw:Pig253Rv	ACGTAAGTCTGAACCAGCCAAG	TCATATCTAAGCATTTCACCGC
Pig23Fw:Pig254Rv	ACGTAAGTCTGAACCAGCCAAG	ACCCAGTAATTCCGGACAACGC
Pig23Fw:Pig255Rv	ACGTAAGTCTGAACCAGCCAAG	GCATTTCACCGCTACACAACGC
Pig23Fw:Pig256Rv	ACGTAAGTCTGAACCAGCCAAG	TCACCGCTACACAACGCATTCC
Pig23Fw:Pig257Rv	ACGTAAGTCTGAACCAGCCAAG	TCACCGCTACACGACGAATTCC
Pig23Fw:Pig258Rv	ACGTAAGTCTGAACCAGCCAAG	GTAAATCCGGACAACGCTTGCC
Pig23Fw:Pig259Rv	ACGTAAGTCTGAACCAGCCAAG	TTCAGGCTCTCGCCCATTGACC
Pig23Fw:Pig260Rv	ACGTAAGTCTGAACCAGCCAAG	GAGGTTTACAATCCGTAGGACC
Pig23Fw:Pig261Rv	ACGTAAGTCTGAACCAGCCAAG	CGTCATATCTAAGCATTTCACC
Pig23Fw:Pig262Rv	ACGTAAGTCTGAACCAGCCAAG	AATCCGGACAACGCTTGCCACC
Pig23Fw:Pig263Rv	ACGTAAGTCTGAACCAGCCAAG	CCGCCTACGCACCCTTTAAACC
Pig23Fw:Pig264Rv	ACGTAAGTCTGAACCAGCCAAG	GTTCAGGCTCTCGCCCATTGAC
Pig23Fw:Pig265Rv	ACGTAAGTCTGAACCAGCCAAG	AGAGGTTTACAATCCGTAGGAC
Pig23Fw:Pig266Rv	ACGTAAGTCTGAACCAGCCAAG	AAGCATTTCACCGCTACACGAC
Pig23Fw:Pig267Rv	ACGTAAGTCTGAACCAGCCAAG	AAATCCGGACAACGCTTGCCAC
Pig23Fw:Pig268Rv	ACGTAAGTCTGAACCAGCCAAG	AATTCCGGACAACGCTCGCCAC
Pig23Fw:Pig269Rv	ACGTAAGTCTGAACCAGCCAAG	ACACCCAGTAATTCCGGACAAC
Pig23Fw:Pig270Rv	ACGTAAGTCTGAACCAGCCAAG	ATGCATTTCACCGCTACACAAC
Pig23Fw:Pig271Rv	ACGTAAGTCTGAACCAGCCAAG	GCACGGAGTTAGCCGATGCTTA
Pig23Fw:Pig272Rv	ACGTAAGTCTGAACCAGCCAAG	GACAACGCTCGCCACCTACGTA
Pig23Fw:Pig273Rv	ACGTAAGTCTGAACCAGCCAAG	TCGGAGTTCTGCGTCATATCTA
Pig23Fw:Pig274Rv	ACGTAAGTCTGAACCAGCCAAG	GCAATCGGAGTTCTGCGTCATA
Pig23Fw:Pig275Rv	ACGTAAGTCTGAACCAGCCAAG	GGTTCAGGCTCTCGCCCATTGA
Pig23Fw:Pig276Rv	ACGTAAGTCTGAACCAGCCAAG	CTTTACGCCCAATAATTCCGGA
Pig23Fw:Pig277Rv	ACGTAAGTCTGAACCAGCCAAG	AAGAGGTTTACAATCCGTAGGA
Pig23Fw:Pig278Rv	ACGTAAGTCTGAACCAGCCAAG	GCATTTCACCGCTACACGACGA
Pig23Fw:Pig279Rv	ACGTAAGTCTGAACCAGCCAAG	TAAGCATTTCACCGCTACACGA
Pig23Fw:Pig280Rv	ACGTAAGTCTGAACCAGCCAAG	CTCACGCGACTTGGCTGGTTCA
Pig23Fw:Pig281Rv	ACGTAAGTCTGAACCAGCCAAG	CATTTCACCGCTACACAACGCA
Pig23Fw:Pig282Rv	ACGTAAGTCTGAACCAGCCAAG	TAAATCCGGACAACGCTTGCCA
Pig23Fw:Pig283Rv	ACGTAAGTCTGAACCAGCCAAG	TAATTCCGGACAACGCTCGCCA
Pig23Fw:Pig284Rv	ACGTAAGTCTGAACCAGCCAAG	TCAGGCTCTCGCCCATTGACCA
Pig23Fw:Pig285Rv	ACGTAAGTCTGAACCAGCCAAG	CTATGCATTTCACCGCTACACA
Pig23Fw:Pig286Rv	ACGTAAGTCTGAACCAGCCAAG	CATTTCACCGCTACACGACGAA
Pig23Fw:Pig287Rv	ACGTAAGTCTGAACCAGCCAAG	CAGGCTCTCGCCCATTGACCAA
Pig23Fw:Pig288Rv	ACGTAAGTCTGAACCAGCCAAG	TACACCCAGTAATTCCGGACAA
Pig23Fw:Pig289Rv	ACGTAAGTCTGAACCAGCCAAG	TATGCATTTCACCGCTACACAA
Pig25Fw:Pig1Rv	ACTCCGATTGCGAAGGCAGCTT	CCTGCACGCTACTTGGCTGGTT
Pig25Fw:Pig2Rv	ACTCCGATTGCGAAGGCAGCTT	AGCTGCCTTCGCAATCGGAGTT
Pig25Fw:Pig3Rv	ACTCCGATTGCGAAGGCAGCTT	TGCCTTCGCAATCGGAGTTCTT
Pig25Fw:Pig4Rv	ACTCCGATTGCGAAGGCAGCTT	GGCACGGAGTTAGCCGATGCTT
Pig25Fw:Pig5Rv	ACTCCGATTGCGAAGGCAGCTT	CGCGGCATTTCACAACACGCTT
Pig25Fw:Pig6Rv	ACTCCGATTGCGAAGGCAGCTT	CCAGTAAATCCGGACAACGCTT
Pig25Fw:Pig7Rv	ACTCCGATTGCGAAGGCAGCTT	CGATACCCGCACTTTCGAGCTT
Pig25Fw:Pig8Rv	ACTCCGATTGCGAAGGCAGCTT	GGCACGGAATTAGCCGGTCCTT
Pig25Fw:Pig9Rv	ACTCCGATTGCGAAGGCAGCTT	TAACGCTACGGTAAGCTGCCTT
Pig25Fw:Pig10Rv	ACTCCGATTGCGAAGGCAGCTT	GCCGTCATCCTGCACGCTACTT
Pig25Fw:Pig11Rv	ACTCCGATTGCGAAGGCAGCTT	ACGGAATTAGCCGGTCCTTATT
Pig25Fw:Pig12Rv	ACTCCGATTGCGAAGGCAGCTT	TAACGCTCGCATCCTCCGTATT
Pig25Fw:Pig13Rv	ACTCCGATTGCGAAGGCAGCTT	CAACGCTTGCCACCTACGTATT
Pig25Fw:Pig14Rv	ACTCCGATTGCGAAGGCAGCTT	CTGGTTCAGACTTCCGTCCATT
Pig25Fw:Pig15Rv	ACTCCGATTGCGAAGGCAGCTT	CTGGTTCAGACTTACGTCCATT
Pig25Fw:Pig16Rv	ACTCCGATTGCGAAGGCAGCTT	TTTCACCGCTACACTAGGAATT
Pig25Fw:Pig17Rv	ACTCCGATTGCGAAGGCAGCTT	TCCTGCACGCTACTTGGCTGGT
Pig25Fw:Pig18Rv	ACTCCGATTGCGAAGGCAGCTT	TGCTGGCACGGAATTAGCCGGT
Pig25Fw:Pig19Rv	ACTCCGATTGCGAAGGCAGCTT	CCGCACTTTCGAGCTTCAGCGT
Pig25Fw:Pig20Rv	ACTCCGATTGCGAAGGCAGCTT	CTTGGCTGGTTCAGACTTCCGT
Pig25Fw:Pig21Rv	ACTCCGATTGCGAAGGCAGCTT	AGTTTACAACCCATAGGGCCGT
Pig25Fw:Pig22Rv	ACTCCGATTGCGAAGGCAGCTT	CTGCTGGCACGTAGTTAGCCGT
Pig25Fw:Pig23Rv	ACTCCGATTGCGAAGGCAGCTT	CTTGGCTGGTTCAGACTTACGT
Pig25Fw:Pig24Rv	ACTCCGATTGCGAAGGCAGCTT	GGACAACGCTTGCCACCTACGT
Pig25Fw:Pig25Rv	ACTCCGATTGCGAAGGCAGCTT	AAGCTGCCTTCGCAATCGGAGT
Pig25Fw:Pig26Rv	ACTCCGATTGCGAAGGCAGCTT	CTGCCTTCGCAATCGGAGTTCT
Pig25Fw:Pig27Rv	ACTCCGATTGCGAAGGCAGCTT	ATCGGAGTTCTTCGTGATATCT
Pig25Fw:Pig28Rv	ACTCCGATTGCGAAGGCAGCTT	ACTGGTGTTCCTCCTAATATCT
Pig25Fw:Pig29Rv	ACTCCGATTGCGAAGGCAGCTT	CTTCCGTATTACCGCGGCTGCT
Pig25Fw:Pig30Rv	ACTCCGATTGCGAAGGCAGCTT	CCTACGTATTACCGCGGCTGCT
Pig25Fw:Pig31Rv	ACTCCGATTGCGAAGGCAGCTT	TGGCACGGAGTTAGCCGATGCT
Pig25Fw:Pig32Rv	ACTCCGATTGCGAAGGCAGCTT	TCATCCTGCACGCTACTTGGCT
Pig25Fw:Pig33Rv	ACTCCGATTGCGAAGGCAGCTT	GACCTTCCGTATTACCGCGGCT
Pig25Fw:Pig34Rv	ACTCCGATTGCGAAGGCAGCTT	CATCCTCCGTATTACCGCGGCT
Pig25Fw:Pig35Rv	ACTCCGATTGCGAAGGCAGCTT	CCACCTACGTATTACCGCGGCT
Pig25Fw:Pig36Rv	ACTCCGATTGCGAAGGCAGCTT	AATATCTACGCATTTCACCGCT
Pig25Fw:Pig37Rv	ACTCCGATTGCGAAGGCAGCTT	GATATCTAAGCATTTCACCGCT
Pig25Fw:Pig38Rv	ACTCCGATTGCGAAGGCAGCTT	CATATCTAAGCATTTCACCGCT
Pig25Fw:Pig39Rv	ACTCCGATTGCGAAGGCAGCTT	CCGCGGCATTTCACAACACGCT
Pig25Fw:Pig40Rv	ACTCCGATTGCGAAGGCAGCTT	CCCAGTAAATCCGGACAACGCT
Pig25Fw:Pig41Rv	ACTCCGATTGCGAAGGCAGCTT	TGGCACGGAATTAGCCGGTCCT
Pig25Fw:Pig42Rv	ACTCCGATTGCGAAGGCAGCTT	CTTCGCCACTGGTGTTCCTCCT
Pig25Fw:Pig43Rv	ACTCCGATTGCGAAGGCAGCTT	CAACCCATAGGGCCGTCATCCT
Pig25Fw:Pig44Rv	ACTCCGATTGCGAAGGCAGCTT	CGCTACACCACGAATTCCGCCT
Pig25Fw:Pig45Rv	ACTCCGATTGCGAAGGCAGCTT	GGTCCTTATTCATGCGGTACCT
Pig25Fw:Pig46Rv	ACTCCGATTGCGAAGGCAGCTT	ACACCACGAATTCCGCCTACCT
Pig25Fw:Pig47Rv	ACTCCGATTGCGAAGGCAGCTT	CGCTACTTGGCTGGTTCAGACT
Pig25Fw:Pig48Rv	ACTCCGATTGCGAAGGCAGCTT	CACGGAATTAGCCGGTCCTTAT
Pig25Fw:Pig49Rv	ACTCCGATTGCGAAGGCAGCTT	ATAACGCTCGCATCCTCCGTAT
Pig25Fw:Pig50Rv	ACTCCGATTGCGAAGGCAGCTT	ACAACGCTTGCCACCTACGTAT
Pig25Fw:Pig51Rv	ACTCCGATTGCGAAGGCAGCTT	CAATCGGAGTTCTTCGTGATAT
Pig25Fw:Pig52Rv	ACTCCGATTGCGAAGGCAGCTT	CCACTGGTGTTCCTCCTAATAT
Pig25Fw:Pig53Rv	ACTCCGATTGCGAAGGCAGCTT	CGCAATCGGAGTTCTTCGTGAT
Pig25Fw:Pig54Rv	ACTCCGATTGCGAAGGCAGCTT	TGCTGGCACGGAGTTAGCCGAT
Pig25Fw:Pig55Rv	ACTCCGATTGCGAAGGCAGCTT	TTACAACCCATAGGGCCGTCAT
Pig25Fw:Pig56Rv	ACTCCGATTGCGAAGGCAGCTT	GTTCCTCCTAATATCTACGCAT
Pig25Fw:Pig57Rv	ACTCCGATTGCGAAGGCAGCTT	GCTGGTTCAGACTTCCGTCCAT
Pig25Fw:Pig58Rv	ACTCCGATTGCGAAGGCAGCTT	GCTGGTTCAGACTTACGTCCAT
Pig25Fw:Pig59Rv	ACTCCGATTGCGAAGGCAGCTT	CGCCACTGGTGTTCCTCCTAAT
Pig25Fw:Pig60Rv	ACTCCGATTGCGAAGGCAGCTT	ATTTCACCGCTACACTAGGAAT
Pig25Fw:Pig61Rv	ACTCCGATTGCGAAGGCAGCTT	TACGGTAAGCTGCCTTCGCAAT
Pig25Fw:Pig62Rv	ACTCCGATTGCGAAGGCAGCTT	CTACGCTCCCTTTAAACCCAAT
Pig25Fw:Pig63Rv	ACTCCGATTGCGAAGGCAGCTT	CAGTAAATCCGGACAACGCTTG
Pig25Fw:Pig64Rv	ACTCCGATTGCGAAGGCAGCTT	CCGTCATCCTGCACGCTACTTG
Pig25Fw:Pig65Rv	ACTCCGATTGCGAAGGCAGCTT	TGGTTCAGACTTCCGTCCATTG
Pig25Fw:Pig66Rv	ACTCCGATTGCGAAGGCAGCTT	TGGTTCAGACTTACGTCCATTG
Pig25Fw:Pig67Rv	ACTCCGATTGCGAAGGCAGCTT	TGCCTTCGCAATCGGAGTTCTG
Pig25Fw:Pig68Rv	ACTCCGATTGCGAAGGCAGCTT	TTCCGTATTACCGCGGCTGCTG
Pig25Fw:Pig69Rv	ACTCCGATTGCGAAGGCAGCTT	CTACGTATTACCGCGGCTGCTG
Pig25Fw:Pig70Rv	ACTCCGATTGCGAAGGCAGCTT	CATCCTGCACGCTACTTGGCTG
Pig25Fw:Pig71Rv	ACTCCGATTGCGAAGGCAGCTT	ACCTTCCGTATTACCGCGGCTG
Pig25Fw:Pig72Rv	ACTCCGATTGCGAAGGCAGCTT	ATCCTCCGTATTACCGCGGCTG
Pig25Fw:Pig73Rv	ACTCCGATTGCGAAGGCAGCTT	CACCTACGTATTACCGCGGCTG
Pig25Fw:Pig74Rv	ACTCCGATTGCGAAGGCAGCTT	AACCCATAGGGCCGTCATCCTG
Pig25Fw:Pig75Rv	ACTCCGATTGCGAAGGCAGCTT	GTCCTTATTCATGCGGTACCTG
Pig25Fw:Pig76Rv	ACTCCGATTGCGAAGGCAGCTT	AATTAGCCGGTCCTTATTCATG
Pig25Fw:Pig77Rv	ACTCCGATTGCGAAGGCAGCTT	CGTCATCCTGCACGCTACTTGG
Pig25Fw:Pig78Rv	ACTCCGATTGCGAAGGCAGCTT	TACGTATTACCGCGGCTGCTGG
Pig25Fw:Pig79Rv	ACTCCGATTGCGAAGGCAGCTT	ATCCTGCACGCTACTTGGCTGG
Pig25Fw:Pig80Rv	ACTCCGATTGCGAAGGCAGCTT	AAGCAGTTTACAACCCATAGGG
Pig25Fw:Pig81Rv	ACTCCGATTGCGAAGGCAGCTT	GGTAAGCTGCCTTCGCAATCGG
Pig25Fw:Pig82Rv	ACTCCGATTGCGAAGGCAGCTT	TAGCCGGTCCTTATTCATGCGG
Pig25Fw:Pig83Rv	ACTCCGATTGCGAAGGCAGCTT	TGCCACCTACGTATTACCGCGG
Pig25Fw:Pig84Rv	ACTCCGATTGCGAAGGCAGCTT	CGCATTTCACCGCTACACTAGG
Pig25Fw:Pig85Rv	ACTCCGATTGCGAAGGCAGCTT	AAAGCAGTTTACAACCCATAGG
Pig25Fw:Pig86Rv	ACTCCGATTGCGAAGGCAGCTT	ACGCTACGGTAAGCTGCCTTCG
Pig25Fw:Pig87Rv	ACTCCGATTGCGAAGGCAGCTT	CGGTAAGCTGCCTTCGCAATCG
Pig25Fw:Pig88Rv	ACTCCGATTGCGAAGGCAGCTT	TTAGCCGGTCCTTATTCATGCG
Pig25Fw:Pig89Rv	ACTCCGATTGCGAAGGCAGCTT	TCGCATCCTCCGTATTACCGCG
Pig25Fw:Pig90Rv	ACTCCGATTGCGAAGGCAGCTT	TTGCCACCTACGTATTACCGCG
Pig25Fw:Pig91Rv	ACTCCGATTGCGAAGGCAGCTT	TCGCCACCTACGTATTACCGCG
Pig25Fw:Pig92Rv	ACTCCGATTGCGAAGGCAGCTT	CAGTTTACAACCCATAGGGCCG
Pig25Fw:Pig93Rv	ACTCCGATTGCGAAGGCAGCTT	GCTCGCATCCTCCGTATTACCG
Pig25Fw:Pig94Rv	ACTCCGATTGCGAAGGCAGCTT	GCTTGCCACCTACGTATTACCG
Pig25Fw:Pig95Rv	ACTCCGATTGCGAAGGCAGCTT	GCTCGCCACCTACGTATTACCG
Pig25Fw:Pig96Rv	ACTCCGATTGCGAAGGCAGCTT	CTAATATCTACGCATTTCACCG
Pig25Fw:Pig97Rv	ACTCCGATTGCGAAGGCAGCTT	GGTGTTCCTCCTAATATCTACG
Pig25Fw:Pig98Rv	ACTCCGATTGCGAAGGCAGCTT	CACCCAGTAAATCCGGACAACG
Pig25Fw:Pig99Rv	ACTCCGATTGCGAAGGCAGCTT	ACGCATTTCACCGCTACACTAG
Pig25Fw:Pig100Rv	ACTCCGATTGCGAAGGCAGCTT	TAAGCTGCCTTCGCAATCGGAG
Pig25Fw:Pig101Rv	ACTCCGATTGCGAAGGCAGCTT	GCACGCTACTTGGCTGGTTCAG
Pig25Fw:Pig102Rv	ACTCCGATTGCGAAGGCAGCTT	TCACGCGACTTGGCTGGTTCAG
Pig25Fw:Pig103Rv	ACTCCGATTGCGAAGGCAGCTT	TACCCGCACTTTCGAGCTTCAG
Pig25Fw:Pig104Rv	ACTCCGATTGCGAAGGCAGCTT	GGAGTTCTTCGTGATATCTAAG
Pig25Fw:Pig105Rv	ACTCCGATTGCGAAGGCAGCTT	CCTCCTAATATCTACGCATTTC
Pig25Fw:Pig106Rv	ACTCCGATTGCGAAGGCAGCTT	CTGCACGCTACTTGGCTGGTTC
Pig25Fw:Pig107Rv	ACTCCGATTGCGAAGGCAGCTT	GCTGCCTTCGCAATCGGAGTTC
Pig25Fw:Pig108Rv	ACTCCGATTGCGAAGGCAGCTT	GATACCCGCACTTTCGAGCTTC
Pig25Fw:Pig109Rv	ACTCCGATTGCGAAGGCAGCTT	AACGCTACGGTAAGCTGCCTTC
Pig25Fw:Pig110Rv	ACTCCGATTGCGAAGGCAGCTT	TTCACCGCTACACTAGGAATTC
Pig25Fw:Pig111Rv	ACTCCGATTGCGAAGGCAGCTT	CGCACTTTCGAGCTTCAGCGTC
Pig25Fw:Pig112Rv	ACTCCGATTGCGAAGGCAGCTT	TTGGCTGGTTCAGACTTCCGTC
Pig25Fw:Pig113Rv	ACTCCGATTGCGAAGGCAGCTT	GTTTACAACCCATAGGGCCGTC
Pig25Fw:Pig114Rv	ACTCCGATTGCGAAGGCAGCTT	TTGGCTGGTTCAGACTTACGTC
Pig25Fw:Pig115Rv	ACTCCGATTGCGAAGGCAGCTT	CACCACGAATTCCGCCTACCTC
Pig25Fw:Pig116Rv	ACTCCGATTGCGAAGGCAGCTT	AATCGGAGTTCTTCGTGATATC
Pig25Fw:Pig117Rv	ACTCCGATTGCGAAGGCAGCTT	CACTGGTGTTCCTCCTAATATC
Pig25Fw:Pig118Rv	ACTCCGATTGCGAAGGCAGCTT	TACAACCCATAGGGCCGTCATC
Pig25Fw:Pig119Rv	ACTCCGATTGCGAAGGCAGCTT	ACGGTAAGCTGCCTTCGCAATC
Pig25Fw:Pig120Rv	ACTCCGATTGCGAAGGCAGCTT	AGTAAATCCGGACAACGCTTGC
Pig25Fw:Pig121Rv	ACTCCGATTGCGAAGGCAGCTT	GCCTTCGCAATCGGAGTTCTGC
Pig25Fw:Pig122Rv	ACTCCGATTGCGAAGGCAGCTT	ACCTACGTATTACCGCGGCTGC
Pig25Fw:Pig123Rv	ACTCCGATTGCGAAGGCAGCTT	TCCTTATTCATGCGGTACCTGC
Pig25Fw:Pig124Rv	ACTCCGATTGCGAAGGCAGCTT	ATTAGCCGGTCCTTATTCATGC
Pig25Fw:Pig125Rv	ACTCCGATTGCGAAGGCAGCTT	GTCATCCTGCACGCTACTTGGC
Pig25Fw:Pig126Rv	ACTCCGATTGCGAAGGCAGCTT	AGCAGTTTACAACCCATAGGGC
Pig25Fw:Pig127Rv	ACTCCGATTGCGAAGGCAGCTT	CTCGCATCCTCCGTATTACCGC
Pig25Fw:Pig128Rv	ACTCCGATTGCGAAGGCAGCTT	CTTGCCACCTACGTATTACCGC
Pig25Fw:Pig129Rv	ACTCCGATTGCGAAGGCAGCTT	CTCGCCACCTACGTATTACCGC
Pig25Fw:Pig130Rv	ACTCCGATTGCGAAGGCAGCTT	TAATATCTACGCATTTCACCGC
Pig25Fw:Pig131Rv	ACTCCGATTGCGAAGGCAGCTT	TGATATCTAAGCATTTCACCGC
Pig25Fw:Pig132Rv	ACTCCGATTGCGAAGGCAGCTT	GTGTTCCTCCTAATATCTACGC
Pig25Fw:Pig133Rv	ACTCCGATTGCGAAGGCAGCTT	ACCCAGTAAATCCGGACAACGC
Pig25Fw:Pig134Rv	ACTCCGATTGCGAAGGCAGCTT	ACCCGCACTTTCGAGCTTCAGC
Pig25Fw:Pig135Rv	ACTCCGATTGCGAAGGCAGCTT	GAGTTCTTCGTGATATCTAAGC
Pig25Fw:Pig136Rv	ACTCCGATTGCGAAGGCAGCTT	TGGCTGGTTCAGACTTCCGTCC
Pig25Fw:Pig137Rv	ACTCCGATTGCGAAGGCAGCTT	TGGCTGGTTCAGACTTACGTCC
Pig25Fw:Pig138Rv	ACTCCGATTGCGAAGGCAGCTT	ACCACGAATTCCGCCTACCTCC
Pig25Fw:Pig139Rv	ACTCCGATTGCGAAGGCAGCTT	ACAACCCATAGGGCCGTCATCC
Pig25Fw:Pig140Rv	ACTCCGATTGCGAAGGCAGCTT	GCAGTTTACAACCCATAGGGCC
Pig25Fw:Pig141Rv	ACTCCGATTGCGAAGGCAGCTT	GGCCTACGCTCCCTTTAAACCC
Pig25Fw:Pig142Rv	ACTCCGATTGCGAAGGCAGCTT	CGCTCGCATCCTCCGTATTACC
Pig25Fw:Pig143Rv	ACTCCGATTGCGAAGGCAGCTT	CGCTTGCCACCTACGTATTACC
Pig25Fw:Pig144Rv	ACTCCGATTGCGAAGGCAGCTT	CGCTCGCCACCTACGTATTACC
Pig25Fw:Pig145Rv	ACTCCGATTGCGAAGGCAGCTT	TACACCACGAATTCCGCCTACC
Pig25Fw:Pig146Rv	ACTCCGATTGCGAAGGCAGCTT	TTCAGACTTCCGTCCATTGACC
Pig25Fw:Pig147Rv	ACTCCGATTGCGAAGGCAGCTT	TTCAGACTTACGTCCATTGACC
Pig25Fw:Pig148Rv	ACTCCGATTGCGAAGGCAGCTT	CCTAATATCTACGCATTTCACC
Pig25Fw:Pig149Rv	ACTCCGATTGCGAAGGCAGCTT	CGGCCTACGCTCCCTTTAAACC
Pig25Fw:Pig150Rv	ACTCCGATTGCGAAGGCAGCTT	ACGCTCGCATCCTCCGTATTAC
Pig25Fw:Pig151Rv	ACTCCGATTGCGAAGGCAGCTT	ACGCTTGCCACCTACGTATTAC
Pig25Fw:Pig152Rv	ACTCCGATTGCGAAGGCAGCTT	ACGCTCGCCACCTACGTATTAC
Pig25Fw:Pig153Rv	ACTCCGATTGCGAAGGCAGCTT	TGGTGTTCCTCCTAATATCTAC
Pig25Fw:Pig154Rv	ACTCCGATTGCGAAGGCAGCTT	TATCTATGCATTTCACCGCTAC
Pig25Fw:Pig155Rv	ACTCCGATTGCGAAGGCAGCTT	TATCTAAGCATTTCACCGCTAC
Pig25Fw:Pig156Rv	ACTCCGATTGCGAAGGCAGCTT	GTTCAGACTTCCGTCCATTGAC
Pig25Fw:Pig157Rv	ACTCCGATTGCGAAGGCAGCTT	GTTCAGACTTACGTCCATTGAC
Pig25Fw:Pig158Rv	ACTCCGATTGCGAAGGCAGCTT	ACGCTACTTGGCTGGTTCAGAC
Pig25Fw:Pig159Rv	ACTCCGATTGCGAAGGCAGCTT	TCTATGCATTTCACCGCTACAC
Pig25Fw:Pig160Rv	ACTCCGATTGCGAAGGCAGCTT	TCTAAGCATTTCACCGCTACAC
Pig25Fw:Pig161Rv	ACTCCGATTGCGAAGGCAGCTT	ACACCCAGTAAATCCGGACAAC
Pig25Fw:Pig162Rv	ACTCCGATTGCGAAGGCAGCTT	CCGGCCTACGCTCCCTTTAAAC
Pig25Fw:Pig163Rv	ACTCCGATTGCGAAGGCAGCTT	ACGGCCTACGCTCCCTTTAAAC
Pig25Fw:Pig164Rv	ACTCCGATTGCGAAGGCAGCTT	AAGCCGGCCTACGCTCCCTTTA
Pig25Fw:Pig165Rv	ACTCCGATTGCGAAGGCAGCTT	GCGGCATTTCACAACACGCTTA
Pig25Fw:Pig166Rv	ACTCCGATTGCGAAGGCAGCTT	GCACGGAATTAGCCGGTCCTTA
Pig25Fw:Pig167Rv	ACTCCGATTGCGAAGGCAGCTT	AACGCTCGCATCCTCCGTATTA
Pig25Fw:Pig168Rv	ACTCCGATTGCGAAGGCAGCTT	AACGCTTGCCACCTACGTATTA
Pig25Fw:Pig169Rv	ACTCCGATTGCGAAGGCAGCTT	AACGCTCGCCACCTACGTATTA
Pig25Fw:Pig170Rv	ACTCCGATTGCGAAGGCAGCTT	GATAACGCTCGCATCCTCCGTA
Pig25Fw:Pig171Rv	ACTCCGATTGCGAAGGCAGCTT	GACAACGCTTGCCACCTACGTA
Pig25Fw:Pig172Rv	ACTCCGATTGCGAAGGCAGCTT	TCGGAGTTCTTCGTGATATCTA
Pig25Fw:Pig173Rv	ACTCCGATTGCGAAGGCAGCTT	CTGGTGTTCCTCCTAATATCTA
Pig25Fw:Pig174Rv	ACTCCGATTGCGAAGGCAGCTT	ATATCTACGCATTTCACCGCTA
Pig25Fw:Pig175Rv	ACTCCGATTGCGAAGGCAGCTT	TTCGCCACTGGTGTTCCTCCTA
Pig25Fw:Pig176Rv	ACTCCGATTGCGAAGGCAGCTT	GCTACACCACGAATTCCGCCTA
Pig25Fw:Pig177Rv	ACTCCGATTGCGAAGGCAGCTT	TCCGGACAACGCTTGCCACCTA
Pig25Fw:Pig178Rv	ACTCCGATTGCGAAGGCAGCTT	TACGCATTTCACCGCTACACTA
Pig25Fw:Pig179Rv	ACTCCGATTGCGAAGGCAGCTT	GCAATCGGAGTTCTTCGTGATA
Pig25Fw:Pig180Rv	ACTCCGATTGCGAAGGCAGCTT	GCCACTGGTGTTCCTCCTAATA
Pig25Fw:Pig181Rv	ACTCCGATTGCGAAGGCAGCTT	TACGCTCCCTTTAAACCCAATA
Pig25Fw:Pig182Rv	ACTCCGATTGCGAAGGCAGCTT	GGTTCAGACTTCCGTCCATTGA
Pig25Fw:Pig183Rv	ACTCCGATTGCGAAGGCAGCTT	GGTTCAGACTTACGTCCATTGA
Pig25Fw:Pig184Rv	ACTCCGATTGCGAAGGCAGCTT	TCGCAATCGGAGTTCTTCGTGA
Pig25Fw:Pig185Rv	ACTCCGATTGCGAAGGCAGCTT	GTAAGCTGCCTTCGCAATCGGA
Pig25Fw:Pig186Rv	ACTCCGATTGCGAAGGCAGCTT	GCATTTCACCGCTACACTAGGA
Pig25Fw:Pig187Rv	ACTCCGATTGCGAAGGCAGCTT	CACGCTACTTGGCTGGTTCAGA
Pig25Fw:Pig188Rv	ACTCCGATTGCGAAGGCAGCTT	TGCACGCTACTTGGCTGGTTCA
Pig25Fw:Pig189Rv	ACTCCGATTGCGAAGGCAGCTT	ATACCCGCACTTTCGAGCTTCA
Pig25Fw:Pig190Rv	ACTCCGATTGCGAAGGCAGCTT	GCACTTTCGAGCTTCAGCGTCA
Pig25Fw:Pig191Rv	ACTCCGATTGCGAAGGCAGCTT	TTTACAACCCATAGGGCCGTCA
Pig25Fw:Pig192Rv	ACTCCGATTGCGAAGGCAGCTT	CCTTATTCATGCGGTACCTGCA
Pig25Fw:Pig193Rv	ACTCCGATTGCGAAGGCAGCTT	GCTACGGTAAGCTGCCTTCGCA
Pig25Fw:Pig194Rv	ACTCCGATTGCGAAGGCAGCTT	TGTTCCTCCTAATATCTACGCA
Pig25Fw:Pig195Rv	ACTCCGATTGCGAAGGCAGCTT	GGCTGGTTCAGACTTCCGTCCA
Pig25Fw:Pig196Rv	ACTCCGATTGCGAAGGCAGCTT	GGCTGGTTCAGACTTACGTCCA
Pig25Fw:Pig197Rv	ACTCCGATTGCGAAGGCAGCTT	GCCTACGCTCCCTTTAAACCCA
Pig25Fw:Pig198Rv	ACTCCGATTGCGAAGGCAGCTT	TCAGACTTCCGTCCATTGACCA
Pig25Fw:Pig199Rv	ACTCCGATTGCGAAGGCAGCTT	TCAGACTTACGTCCATTGACCA
Pig25Fw:Pig200Rv	ACTCCGATTGCGAAGGCAGCTT	ATCTATGCATTTCACCGCTACA
Pig25Fw:Pig201Rv	ACTCCGATTGCGAAGGCAGCTT	ATCTAAGCATTTCACCGCTACA
Pig25Fw:Pig202Rv	ACTCCGATTGCGAAGGCAGCTT	AGCCGGCCTACGCTCCCTTTAA
Pig25Fw:Pig203Rv	ACTCCGATTGCGAAGGCAGCTT	CGGCATTTCACAACACGCTTAA
Pig25Fw:Pig204Rv	ACTCCGATTGCGAAGGCAGCTT	CGGAGTTCTTCGTGATATCTAA
Pig25Fw:Pig205Rv	ACTCCGATTGCGAAGGCAGCTT	TCGCCACTGGTGTTCCTCCTAA
Pig25Fw:Pig206Rv	ACTCCGATTGCGAAGGCAGCTT	ACGCTCCCTTTAAACCCAATAA
Pig25Fw:Pig207Rv	ACTCCGATTGCGAAGGCAGCTT	CATTTCACCGCTACACTAGGAA
Pig25Fw:Pig208Rv	ACTCCGATTGCGAAGGCAGCTT	CTTATTCATGCGGTACCTGCAA
Pig25Fw:Pig209Rv	ACTCCGATTGCGAAGGCAGCTT	CTACGGTAAGCTGCCTTCGCAA
Pig25Fw:Pig210Rv	ACTCCGATTGCGAAGGCAGCTT	CCTACGCTCCCTTTAAACCCAA
Pig25Fw:Pig211Rv	ACTCCGATTGCGAAGGCAGCTT	CAGACTTCCGTCCATTGACCAA
Pig25Fw:Pig212Rv	ACTCCGATTGCGAAGGCAGCTT	CAGACTTACGTCCATTGACCAA
Pig25Fw:Pig213Rv	ACTCCGATTGCGAAGGCAGCTT	TACACCCAGTAAATCCGGACAA
Pig25Fw:Pig214Rv	ACTCCGATTGCGAAGGCAGCTT	GCCGGCCTACGCTCCCTTTAAA
Pig25Fw:Pig215Rv	ACTCCGATTGCGAAGGCAGCTT	GGCATTTCACAACACGCTTAAA
Pig25Fw:Pig216Rv	ACTCCGATTGCGAAGGCAGCTT	TTATTCATGCGGTACCTGCAAA
Pig25Fw:Pig217Rv	ACTCCGATTGCGAAGGCAGCTT	GCACGGAGTTAGCCGATGCTTT
Pig25Fw:Pig218Rv	ACTCCGATTGCGAAGGCAGCTT	CCTTCACGCGACTTGGCTGGTT
Pig25Fw:Pig219Rv	ACTCCGATTGCGAAGGCAGCTT	ACGGAGTTAGCCGATGCTTATT
Pig25Fw:Pig220Rv	ACTCCGATTGCGAAGGCAGCTT	CAACGCTCGCCACCTACGTATT
Pig25Fw:Pig221Rv	ACTCCGATTGCGAAGGCAGCTT	TTTCACCGCTACACAACGCATT
Pig25Fw:Pig222Rv	ACTCCGATTGCGAAGGCAGCTT	CTGGTTCAGGCTCTCGCCCATT
Pig25Fw:Pig223Rv	ACTCCGATTGCGAAGGCAGCTT	TTTCACCGCTACACGACGAATT
Pig25Fw:Pig224Rv	ACTCCGATTGCGAAGGCAGCTT	TCCTTCACGCGACTTGGCTGGT
Pig25Fw:Pig225Rv	ACTCCGATTGCGAAGGCAGCTT	ATCGGAGTTCTGCGTCATATCT
Pig25Fw:Pig226Rv	ACTCCGATTGCGAAGGCAGCTT	TCGTCCTGCACGCTACTTGGCT
Pig25Fw:Pig227Rv	ACTCCGATTGCGAAGGCAGCTT	CCCAGTAATTCCGGACAACGCT
Pig25Fw:Pig228Rv	ACTCCGATTGCGAAGGCAGCTT	ATCCGGACAACGCTTGCCACCT
Pig25Fw:Pig229Rv	ACTCCGATTGCGAAGGCAGCTT	CACGGAGTTAGCCGATGCTTAT
Pig25Fw:Pig230Rv	ACTCCGATTGCGAAGGCAGCTT	ACAACGCTCGCCACCTACGTAT
Pig25Fw:Pig231Rv	ACTCCGATTGCGAAGGCAGCTT	CGGAGTTCTGCGTCATATCTAT
Pig25Fw:Pig232Rv	ACTCCGATTGCGAAGGCAGCTT	CAATCGGAGTTCTGCGTCATAT
Pig25Fw:Pig233Rv	ACTCCGATTGCGAAGGCAGCTT	ATTTCACCGCTACACAACGCAT
Pig25Fw:Pig234Rv	ACTCCGATTGCGAAGGCAGCTT	ATTTCACCGCTACACGACGAAT
Pig25Fw:Pig235Rv	ACTCCGATTGCGAAGGCAGCTT	TGGTTCAGGCTCTCGCCCATTG
Pig25Fw:Pig236Rv	ACTCCGATTGCGAAGGCAGCTT	AAAGAGGTTTACAATCCGTAGG
Pig25Fw:Pig237Rv	ACTCCGATTGCGAAGGCAGCTT	CACGCTACTTGGCTGGTTCAGG
Pig25Fw:Pig238Rv	ACTCCGATTGCGAAGGCAGCTT	CACCGCTACACAACGCATTCCG
Pig25Fw:Pig239Rv	ACTCCGATTGCGAAGGCAGCTT	CCCTTTACGCCCAATAATTCCG
Pig25Fw:Pig240Rv	ACTCCGATTGCGAAGGCAGCTT	CACCGCTACACGACGAATTCCG
Pig25Fw:Pig241Rv	ACTCCGATTGCGAAGGCAGCTT	GTCATATCTAAGCATTTCACCG
Pig25Fw:Pig242Rv	ACTCCGATTGCGAAGGCAGCTT	AGCATTTCACCGCTACACGACG
Pig25Fw:Pig243Rv	ACTCCGATTGCGAAGGCAGCTT	CTAAGCATTTCACCGCTACACG
Pig25Fw:Pig244Rv	ACTCCGATTGCGAAGGCAGCTT	CACCCAGTAATTCCGGACAACG
Pig25Fw:Pig245Rv	ACTCCGATTGCGAAGGCAGCTT	TGCATTTCACCGCTACACAACG
Pig25Fw:Pig246Rv	ACTCCGATTGCGAAGGCAGCTT	CAAGCTGCCTTCGCAATCGGAG
Pig25Fw:Pig247Rv	ACTCCGATTGCGAAGGCAGCTT	CTTCACGCGACTTGGCTGGTTC
Pig25Fw:Pig248Rv	ACTCCGATTGCGAAGGCAGCTT	CGGAGTTAGCCGATGCTTATTC
Pig25Fw:Pig249Rv	ACTCCGATTGCGAAGGCAGCTT	TTCACCGCTACACAACGCATTC
Pig25Fw:Pig250Rv	ACTCCGATTGCGAAGGCAGCTT	TTCACCGCTACACGACGAATTC
Pig25Fw:Pig251Rv	ACTCCGATTGCGAAGGCAGCTT	AATCGGAGTTCTGCGTCATATC
Pig25Fw:Pig252Rv	ACTCCGATTGCGAAGGCAGCTT	ACGCTACTTGGCTGGTTCAGGC
Pig25Fw:Pig253Rv	ACTCCGATTGCGAAGGCAGCTT	TCATATCTAAGCATTTCACCGC
Pig25Fw:Pig254Rv	ACTCCGATTGCGAAGGCAGCTT	ACCCAGTAATTCCGGACAACGC
Pig25Fw:Pig255Rv	ACTCCGATTGCGAAGGCAGCTT	GCATTTCACCGCTACACAACGC
Pig25Fw:Pig256Rv	ACTCCGATTGCGAAGGCAGCTT	TCACCGCTACACAACGCATTCC
Pig25Fw:Pig257Rv	ACTCCGATTGCGAAGGCAGCTT	TCACCGCTACACGACGAATTCC
Pig25Fw:Pig258Rv	ACTCCGATTGCGAAGGCAGCTT	GTAAATCCGGACAACGCTTGCC
Pig25Fw:Pig259Rv	ACTCCGATTGCGAAGGCAGCTT	TTCAGGCTCTCGCCCATTGACC
Pig25Fw:Pig260Rv	ACTCCGATTGCGAAGGCAGCTT	GAGGTTTACAATCCGTAGGACC
Pig25Fw:Pig261Rv	ACTCCGATTGCGAAGGCAGCTT	CGTCATATCTAAGCATTTCACC
Pig25Fw:Pig262Rv	ACTCCGATTGCGAAGGCAGCTT	AATCCGGACAACGCTTGCCACC
Pig25Fw:Pig263Rv	ACTCCGATTGCGAAGGCAGCTT	CCGCCTACGCACCCTTTAAACC
Pig25Fw:Pig264Rv	ACTCCGATTGCGAAGGCAGCTT	GTTCAGGCTCTCGCCCATTGAC
Pig25Fw:Pig265Rv	ACTCCGATTGCGAAGGCAGCTT	AGAGGTTTACAATCCGTAGGAC
Pig25Fw:Pig266Rv	ACTCCGATTGCGAAGGCAGCTT	AAGCATTTCACCGCTACACGAC
Pig25Fw:Pig267Rv	ACTCCGATTGCGAAGGCAGCTT	AAATCCGGACAACGCTTGCCAC
Pig25Fw:Pig268Rv	ACTCCGATTGCGAAGGCAGCTT	AATTCCGGACAACGCTCGCCAC
Pig25Fw:Pig269Rv	ACTCCGATTGCGAAGGCAGCTT	ACACCCAGTAATTCCGGACAAC
Pig25Fw:Pig270Rv	ACTCCGATTGCGAAGGCAGCTT	ATGCATTTCACCGCTACACAAC
Pig25Fw:Pig271Rv	ACTCCGATTGCGAAGGCAGCTT	GCACGGAGTTAGCCGATGCTTA
Pig25Fw:Pig272Rv	ACTCCGATTGCGAAGGCAGCTT	GACAACGCTCGCCACCTACGTA
Pig25Fw:Pig273Rv	ACTCCGATTGCGAAGGCAGCTT	TCGGAGTTCTGCGTCATATCTA
Pig25Fw:Pig274Rv	ACTCCGATTGCGAAGGCAGCTT	GCAATCGGAGTTCTGCGTCATA
Pig25Fw:Pig275Rv	ACTCCGATTGCGAAGGCAGCTT	GGTTCAGGCTCTCGCCCATTGA
Pig25Fw:Pig276Rv	ACTCCGATTGCGAAGGCAGCTT	CTTTACGCCCAATAATTCCGGA
Pig25Fw:Pig277Rv	ACTCCGATTGCGAAGGCAGCTT	AAGAGGTTTACAATCCGTAGGA
Pig25Fw:Pig278Rv	ACTCCGATTGCGAAGGCAGCTT	GCATTTCACCGCTACACGACGA
Pig25Fw:Pig279Rv	ACTCCGATTGCGAAGGCAGCTT	TAAGCATTTCACCGCTACACGA
Pig25Fw:Pig280Rv	ACTCCGATTGCGAAGGCAGCTT	CTCACGCGACTTGGCTGGTTCA
Pig25Fw:Pig281Rv	ACTCCGATTGCGAAGGCAGCTT	CATTTCACCGCTACACAACGCA
Pig25Fw:Pig282Rv	ACTCCGATTGCGAAGGCAGCTT	TAAATCCGGACAACGCTTGCCA
Pig25Fw:Pig283Rv	ACTCCGATTGCGAAGGCAGCTT	TAATTCCGGACAACGCTCGCCA
Pig25Fw:Pig284Rv	ACTCCGATTGCGAAGGCAGCTT	TCAGGCTCTCGCCCATTGACCA
Pig25Fw:Pig285Rv	ACTCCGATTGCGAAGGCAGCTT	CTATGCATTTCACCGCTACACA
Pig25Fw:Pig286Rv	ACTCCGATTGCGAAGGCAGCTT	CATTTCACCGCTACACGACGAA
Pig25Fw:Pig287Rv	ACTCCGATTGCGAAGGCAGCTT	CAGGCTCTCGCCCATTGACCAA
Pig25Fw:Pig288Rv	ACTCCGATTGCGAAGGCAGCTT	TACACCCAGTAATTCCGGACAA
Pig25Fw:Pig289Rv	ACTCCGATTGCGAAGGCAGCTT	TATGCATTTCACCGCTACACAA
Pig39Fw:Pig1Rv	AGCGTGTTGTGAAATGCCGCGG	CCTGCACGCTACTTGGCTGGTT
Pig39Fw:Pig2Rv	AGCGTGTTGTGAAATGCCGCGG	AGCTGCCTTCGCAATCGGAGTT
Pig39Fw:Pig3Rv	AGCGTGTTGTGAAATGCCGCGG	TGCCTTCGCAATCGGAGTTCTT
Pig39Fw:Pig4Rv	AGCGTGTTGTGAAATGCCGCGG	GGCACGGAGTTAGCCGATGCTT
Pig39Fw:Pig5Rv	AGCGTGTTGTGAAATGCCGCGG	CGCGGCATTTCACAACACGCTT
Pig39Fw:Pig6Rv	AGCGTGTTGTGAAATGCCGCGG	CCAGTAAATCCGGACAACGCTT
Pig39Fw:Pig7Rv	AGCGTGTTGTGAAATGCCGCGG	CGATACCCGCACTTTCGAGCTT
Pig39Fw:Pig8Rv	AGCGTGTTGTGAAATGCCGCGG	GGCACGGAATTAGCCGGTCCTT
Pig39Fw:Pig9Rv	AGCGTGTTGTGAAATGCCGCGG	TAACGCTACGGTAAGCTGCCTT
Pig39Fw:Pig10Rv	AGCGTGTTGTGAAATGCCGCGG	GCCGTCATCCTGCACGCTACTT
Pig39Fw:Pig11Rv	AGCGTGTTGTGAAATGCCGCGG	ACGGAATTAGCCGGTCCTTATT
Pig39Fw:Pig12Rv	AGCGTGTTGTGAAATGCCGCGG	TAACGCTCGCATCCTCCGTATT
Pig39Fw:Pig13Rv	AGCGTGTTGTGAAATGCCGCGG	CAACGCTTGCCACCTACGTATT
Pig39Fw:Pig14Rv	AGCGTGTTGTGAAATGCCGCGG	CTGGTTCAGACTTCCGTCCATT
Pig39Fw:Pig15Rv	AGCGTGTTGTGAAATGCCGCGG	CTGGTTCAGACTTACGTCCATT
Pig39Fw:Pig16Rv	AGCGTGTTGTGAAATGCCGCGG	TTTCACCGCTACACTAGGAATT
Pig39Fw:Pig17Rv	AGCGTGTTGTGAAATGCCGCGG	TCCTGCACGCTACTTGGCTGGT
Pig39Fw:Pig18Rv	AGCGTGTTGTGAAATGCCGCGG	TGCTGGCACGGAATTAGCCGGT
Pig39Fw:Pig19Rv	AGCGTGTTGTGAAATGCCGCGG	CCGCACTTTCGAGCTTCAGCGT
Pig39Fw:Pig20Rv	AGCGTGTTGTGAAATGCCGCGG	CTTGGCTGGTTCAGACTTCCGT
Pig39Fw:Pig21Rv	AGCGTGTTGTGAAATGCCGCGG	AGTTTACAACCCATAGGGCCGT
Pig39Fw:Pig22Rv	AGCGTGTTGTGAAATGCCGCGG	CTGCTGGCACGTAGTTAGCCGT
Pig39Fw:Pig23Rv	AGCGTGTTGTGAAATGCCGCGG	CTTGGCTGGTTCAGACTTACGT
Pig39Fw:Pig24Rv	AGCGTGTTGTGAAATGCCGCGG	GGACAACGCTTGCCACCTACGT
Pig39Fw:Pig25Rv	AGCGTGTTGTGAAATGCCGCGG	AAGCTGCCTTCGCAATCGGAGT
Pig39Fw:Pig26Rv	AGCGTGTTGTGAAATGCCGCGG	CTGCCTTCGCAATCGGAGTTCT
Pig39Fw:Pig27Rv	AGCGTGTTGTGAAATGCCGCGG	ATCGGAGTTCTTCGTGATATCT
Pig39Fw:Pig28Rv	AGCGTGTTGTGAAATGCCGCGG	ACTGGTGTTCCTCCTAATATCT
Pig39Fw:Pig29Rv	AGCGTGTTGTGAAATGCCGCGG	CTTCCGTATTACCGCGGCTGCT
Pig39Fw:Pig30Rv	AGCGTGTTGTGAAATGCCGCGG	CCTACGTATTACCGCGGCTGCT
Pig39Fw:Pig31Rv	AGCGTGTTGTGAAATGCCGCGG	TGGCACGGAGTTAGCCGATGCT
Pig39Fw:Pig32Rv	AGCGTGTTGTGAAATGCCGCGG	TCATCCTGCACGCTACTTGGCT
Pig39Fw:Pig33Rv	AGCGTGTTGTGAAATGCCGCGG	GACCTTCCGTATTACCGCGGCT
Pig39Fw:Pig34Rv	AGCGTGTTGTGAAATGCCGCGG	CATCCTCCGTATTACCGCGGCT
Pig39Fw:Pig35Rv	AGCGTGTTGTGAAATGCCGCGG	CCACCTACGTATTACCGCGGCT
Pig39Fw:Pig36Rv	AGCGTGTTGTGAAATGCCGCGG	AATATCTACGCATTTCACCGCT
Pig39Fw:Pig37Rv	AGCGTGTTGTGAAATGCCGCGG	GATATCTAAGCATTTCACCGCT
Pig39Fw:Pig38Rv	AGCGTGTTGTGAAATGCCGCGG	CATATCTAAGCATTTCACCGCT
Pig39Fw:Pig39Rv	AGCGTGTTGTGAAATGCCGCGG	CCGCGGCATTTCACAACACGCT
Pig39Fw:Pig40Rv	AGCGTGTTGTGAAATGCCGCGG	CCCAGTAAATCCGGACAACGCT
Pig39Fw:Pig41Rv	AGCGTGTTGTGAAATGCCGCGG	TGGCACGGAATTAGCCGGTCCT
Pig39Fw:Pig42Rv	AGCGTGTTGTGAAATGCCGCGG	CTTCGCCACTGGTGTTCCTCCT
Pig39Fw:Pig43Rv	AGCGTGTTGTGAAATGCCGCGG	CAACCCATAGGGCCGTCATCCT
Pig39Fw:Pig44Rv	AGCGTGTTGTGAAATGCCGCGG	CGCTACACCACGAATTCCGCCT
Pig39Fw:Pig45Rv	AGCGTGTTGTGAAATGCCGCGG	GGTCCTTATTCATGCGGTACCT
Pig39Fw:Pig46Rv	AGCGTGTTGTGAAATGCCGCGG	ACACCACGAATTCCGCCTACCT
Pig39Fw:Pig47Rv	AGCGTGTTGTGAAATGCCGCGG	CGCTACTTGGCTGGTTCAGACT
Pig39Fw:Pig48Rv	AGCGTGTTGTGAAATGCCGCGG	CACGGAATTAGCCGGTCCTTAT
Pig39Fw:Pig49Rv	AGCGTGTTGTGAAATGCCGCGG	ATAACGCTCGCATCCTCCGTAT
Pig39Fw:Pig50Rv	AGCGTGTTGTGAAATGCCGCGG	ACAACGCTTGCCACCTACGTAT
Pig39Fw:Pig51Rv	AGCGTGTTGTGAAATGCCGCGG	CAATCGGAGTTCTTCGTGATAT
Pig39Fw:Pig52Rv	AGCGTGTTGTGAAATGCCGCGG	CCACTGGTGTTCCTCCTAATAT
Pig39Fw:Pig53Rv	AGCGTGTTGTGAAATGCCGCGG	CGCAATCGGAGTTCTTCGTGAT
Pig39Fw:Pig54Rv	AGCGTGTTGTGAAATGCCGCGG	TGCTGGCACGGAGTTAGCCGAT
Pig39Fw:Pig55Rv	AGCGTGTTGTGAAATGCCGCGG	TTACAACCCATAGGGCCGTCAT
Pig39Fw:Pig56Rv	AGCGTGTTGTGAAATGCCGCGG	GTTCCTCCTAATATCTACGCAT
Pig39Fw:Pig57Rv	AGCGTGTTGTGAAATGCCGCGG	GCTGGTTCAGACTTCCGTCCAT
Pig39Fw:Pig58Rv	AGCGTGTTGTGAAATGCCGCGG	GCTGGTTCAGACTTACGTCCAT
Pig39Fw:Pig59Rv	AGCGTGTTGTGAAATGCCGCGG	CGCCACTGGTGTTCCTCCTAAT
Pig39Fw:Pig60Rv	AGCGTGTTGTGAAATGCCGCGG	ATTTCACCGCTACACTAGGAAT
Pig39Fw:Pig61Rv	AGCGTGTTGTGAAATGCCGCGG	TACGGTAAGCTGCCTTCGCAAT
Pig39Fw:Pig62Rv	AGCGTGTTGTGAAATGCCGCGG	CTACGCTCCCTTTAAACCCAAT
Pig39Fw:Pig63Rv	AGCGTGTTGTGAAATGCCGCGG	CAGTAAATCCGGACAACGCTTG
Pig39Fw:Pig64Rv	AGCGTGTTGTGAAATGCCGCGG	CCGTCATCCTGCACGCTACTTG
Pig39Fw:Pig65Rv	AGCGTGTTGTGAAATGCCGCGG	TGGTTCAGACTTCCGTCCATTG
Pig39Fw:Pig66Rv	AGCGTGTTGTGAAATGCCGCGG	TGGTTCAGACTTACGTCCATTG
Pig39Fw:Pig67Rv	AGCGTGTTGTGAAATGCCGCGG	TGCCTTCGCAATCGGAGTTCTG
Pig39Fw:Pig68Rv	AGCGTGTTGTGAAATGCCGCGG	TTCCGTATTACCGCGGCTGCTG
Pig39Fw:Pig69Rv	AGCGTGTTGTGAAATGCCGCGG	CTACGTATTACCGCGGCTGCTG
Pig39Fw:Pig70Rv	AGCGTGTTGTGAAATGCCGCGG	CATCCTGCACGCTACTTGGCTG
Pig39Fw:Pig71Rv	AGCGTGTTGTGAAATGCCGCGG	ACCTTCCGTATTACCGCGGCTG
Pig39Fw:Pig72Rv	AGCGTGTTGTGAAATGCCGCGG	ATCCTCCGTATTACCGCGGCTG
Pig39Fw:Pig73Rv	AGCGTGTTGTGAAATGCCGCGG	CACCTACGTATTACCGCGGCTG
Pig39Fw:Pig74Rv	AGCGTGTTGTGAAATGCCGCGG	AACCCATAGGGCCGTCATCCTG
Pig39Fw:Pig75Rv	AGCGTGTTGTGAAATGCCGCGG	GTCCTTATTCATGCGGTACCTG
Pig39Fw:Pig76Rv	AGCGTGTTGTGAAATGCCGCGG	AATTAGCCGGTCCTTATTCATG
Pig39Fw:Pig77Rv	AGCGTGTTGTGAAATGCCGCGG	CGTCATCCTGCACGCTACTTGG
Pig39Fw:Pig78Rv	AGCGTGTTGTGAAATGCCGCGG	TACGTATTACCGCGGCTGCTGG
Pig39Fw:Pig79Rv	AGCGTGTTGTGAAATGCCGCGG	ATCCTGCACGCTACTTGGCTGG
Pig39Fw:Pig80Rv	AGCGTGTTGTGAAATGCCGCGG	AAGCAGTTTACAACCCATAGGG
Pig39Fw:Pig81Rv	AGCGTGTTGTGAAATGCCGCGG	GGTAAGCTGCCTTCGCAATCGG
Pig39Fw:Pig82Rv	AGCGTGTTGTGAAATGCCGCGG	TAGCCGGTCCTTATTCATGCGG
Pig39Fw:Pig83Rv	AGCGTGTTGTGAAATGCCGCGG	TGCCACCTACGTATTACCGCGG
Pig39Fw:Pig84Rv	AGCGTGTTGTGAAATGCCGCGG	CGCATTTCACCGCTACACTAGG
Pig39Fw:Pig85Rv	AGCGTGTTGTGAAATGCCGCGG	AAAGCAGTTTACAACCCATAGG
Pig39Fw:Pig86Rv	AGCGTGTTGTGAAATGCCGCGG	ACGCTACGGTAAGCTGCCTTCG
Pig39Fw:Pig87Rv	AGCGTGTTGTGAAATGCCGCGG	CGGTAAGCTGCCTTCGCAATCG
Pig39Fw:Pig88Rv	AGCGTGTTGTGAAATGCCGCGG	TTAGCCGGTCCTTATTCATGCG
Pig39Fw:Pig89Rv	AGCGTGTTGTGAAATGCCGCGG	TCGCATCCTCCGTATTACCGCG
Pig39Fw:Pig90Rv	AGCGTGTTGTGAAATGCCGCGG	TTGCCACCTACGTATTACCGCG
Pig39Fw:Pig91Rv	AGCGTGTTGTGAAATGCCGCGG	TCGCCACCTACGTATTACCGCG
Pig39Fw:Pig92Rv	AGCGTGTTGTGAAATGCCGCGG	CAGTTTACAACCCATAGGGCCG
Pig39Fw:Pig93Rv	AGCGTGTTGTGAAATGCCGCGG	GCTCGCATCCTCCGTATTACCG
Pig39Fw:Pig94Rv	AGCGTGTTGTGAAATGCCGCGG	GCTTGCCACCTACGTATTACCG
Pig39Fw:Pig95Rv	AGCGTGTTGTGAAATGCCGCGG	GCTCGCCACCTACGTATTACCG
Pig39Fw:Pig96Rv	AGCGTGTTGTGAAATGCCGCGG	CTAATATCTACGCATTTCACCG
Pig39Fw:Pig97Rv	AGCGTGTTGTGAAATGCCGCGG	GGTGTTCCTCCTAATATCTACG
Pig39Fw:Pig98Rv	AGCGTGTTGTGAAATGCCGCGG	CACCCAGTAAATCCGGACAACG
Pig39Fw:Pig99Rv	AGCGTGTTGTGAAATGCCGCGG	ACGCATTTCACCGCTACACTAG
Pig39Fw:Pig100Rv	AGCGTGTTGTGAAATGCCGCGG	TAAGCTGCCTTCGCAATCGGAG
Pig39Fw:Pig101Rv	AGCGTGTTGTGAAATGCCGCGG	GCACGCTACTTGGCTGGTTCAG
Pig39Fw:Pig102Rv	AGCGTGTTGTGAAATGCCGCGG	TCACGCGACTTGGCTGGTTCAG
Pig39Fw:Pig103Rv	AGCGTGTTGTGAAATGCCGCGG	TACCCGCACTTTCGAGCTTCAG
Pig39Fw:Pig104Rv	AGCGTGTTGTGAAATGCCGCGG	GGAGTTCTTCGTGATATCTAAG
Pig39Fw:Pig105Rv	AGCGTGTTGTGAAATGCCGCGG	CCTCCTAATATCTACGCATTTC
Pig39Fw:Pig106Rv	AGCGTGTTGTGAAATGCCGCGG	CTGCACGCTACTTGGCTGGTTC
Pig39Fw:Pig107Rv	AGCGTGTTGTGAAATGCCGCGG	GCTGCCTTCGCAATCGGAGTTC
Pig39Fw:Pig108Rv	AGCGTGTTGTGAAATGCCGCGG	GATACCCGCACTTTCGAGCTTC
Pig39Fw:Pig109Rv	AGCGTGTTGTGAAATGCCGCGG	AACGCTACGGTAAGCTGCCTTC
Pig39Fw:Pig110Rv	AGCGTGTTGTGAAATGCCGCGG	TTCACCGCTACACTAGGAATTC
Pig39Fw:Pig111Rv	AGCGTGTTGTGAAATGCCGCGG	CGCACTTTCGAGCTTCAGCGTC
Pig39Fw:Pig112Rv	AGCGTGTTGTGAAATGCCGCGG	TTGGCTGGTTCAGACTTCCGTC
Pig39Fw:Pig113Rv	AGCGTGTTGTGAAATGCCGCGG	GTTTACAACCCATAGGGCCGTC
Pig39Fw:Pig114Rv	AGCGTGTTGTGAAATGCCGCGG	TTGGCTGGTTCAGACTTACGTC
Pig39Fw:Pig115Rv	AGCGTGTTGTGAAATGCCGCGG	CACCACGAATTCCGCCTACCTC
Pig39Fw:Pig116Rv	AGCGTGTTGTGAAATGCCGCGG	AATCGGAGTTCTTCGTGATATC
Pig39Fw:Pig117Rv	AGCGTGTTGTGAAATGCCGCGG	CACTGGTGTTCCTCCTAATATC
Pig39Fw:Pig118Rv	AGCGTGTTGTGAAATGCCGCGG	TACAACCCATAGGGCCGTCATC
Pig39Fw:Pig119Rv	AGCGTGTTGTGAAATGCCGCGG	ACGGTAAGCTGCCTTCGCAATC
Pig39Fw:Pig120Rv	AGCGTGTTGTGAAATGCCGCGG	AGTAAATCCGGACAACGCTTGC
Pig39Fw:Pig121Rv	AGCGTGTTGTGAAATGCCGCGG	GCCTTCGCAATCGGAGTTCTGC
Pig39Fw:Pig122Rv	AGCGTGTTGTGAAATGCCGCGG	ACCTACGTATTACCGCGGCTGC
Pig39Fw:Pig123Rv	AGCGTGTTGTGAAATGCCGCGG	TCCTTATTCATGCGGTACCTGC
Pig39Fw:Pig124Rv	AGCGTGTTGTGAAATGCCGCGG	ATTAGCCGGTCCTTATTCATGC
Pig39Fw:Pig125Rv	AGCGTGTTGTGAAATGCCGCGG	GTCATCCTGCACGCTACTTGGC
Pig39Fw:Pig126Rv	AGCGTGTTGTGAAATGCCGCGG	AGCAGTTTACAACCCATAGGGC
Pig39Fw:Pig127Rv	AGCGTGTTGTGAAATGCCGCGG	CTCGCATCCTCCGTATTACCGC
Pig39Fw:Pig128Rv	AGCGTGTTGTGAAATGCCGCGG	CTTGCCACCTACGTATTACCGC
Pig39Fw:Pig129Rv	AGCGTGTTGTGAAATGCCGCGG	CTCGCCACCTACGTATTACCGC
Pig39Fw:Pig130Rv	AGCGTGTTGTGAAATGCCGCGG	TAATATCTACGCATTTCACCGC
Pig39Fw:Pig131Rv	AGCGTGTTGTGAAATGCCGCGG	TGATATCTAAGCATTTCACCGC
Pig39Fw:Pig132Rv	AGCGTGTTGTGAAATGCCGCGG	GTGTTCCTCCTAATATCTACGC
Pig39Fw:Pig133Rv	AGCGTGTTGTGAAATGCCGCGG	ACCCAGTAAATCCGGACAACGC
Pig39Fw:Pig134Rv	AGCGTGTTGTGAAATGCCGCGG	ACCCGCACTTTCGAGCTTCAGC
Pig39Fw:Pig135Rv	AGCGTGTTGTGAAATGCCGCGG	GAGTTCTTCGTGATATCTAAGC
Pig39Fw:Pig136Rv	AGCGTGTTGTGAAATGCCGCGG	TGGCTGGTTCAGACTTCCGTCC
Pig39Fw:Pig137Rv	AGCGTGTTGTGAAATGCCGCGG	TGGCTGGTTCAGACTTACGTCC
Pig39Fw:Pig138Rv	AGCGTGTTGTGAAATGCCGCGG	ACCACGAATTCCGCCTACCTCC
Pig39Fw:Pig139Rv	AGCGTGTTGTGAAATGCCGCGG	ACAACCCATAGGGCCGTCATCC
Pig39Fw:Pig140Rv	AGCGTGTTGTGAAATGCCGCGG	GCAGTTTACAACCCATAGGGCC
Pig39Fw:Pig141Rv	AGCGTGTTGTGAAATGCCGCGG	GGCCTACGCTCCCTTTAAACCC
Pig39Fw:Pig142Rv	AGCGTGTTGTGAAATGCCGCGG	CGCTCGCATCCTCCGTATTACC
Pig39Fw:Pig143Rv	AGCGTGTTGTGAAATGCCGCGG	CGCTTGCCACCTACGTATTACC
Pig39Fw:Pig144Rv	AGCGTGTTGTGAAATGCCGCGG	CGCTCGCCACCTACGTATTACC
Pig39Fw:Pig145Rv	AGCGTGTTGTGAAATGCCGCGG	TACACCACGAATTCCGCCTACC
Pig39Fw:Pig146Rv	AGCGTGTTGTGAAATGCCGCGG	TTCAGACTTCCGTCCATTGACC
Pig39Fw:Pig147Rv	AGCGTGTTGTGAAATGCCGCGG	TTCAGACTTACGTCCATTGACC
Pig39Fw:Pig148Rv	AGCGTGTTGTGAAATGCCGCGG	CCTAATATCTACGCATTTCACC
Pig39Fw:Pig149Rv	AGCGTGTTGTGAAATGCCGCGG	CGGCCTACGCTCCCTTTAAACC
Pig39Fw:Pig150Rv	AGCGTGTTGTGAAATGCCGCGG	ACGCTCGCATCCTCCGTATTAC
Pig39Fw:Pig151Rv	AGCGTGTTGTGAAATGCCGCGG	ACGCTTGCCACCTACGTATTAC
Pig39Fw:Pig152Rv	AGCGTGTTGTGAAATGCCGCGG	ACGCTCGCCACCTACGTATTAC
Pig39Fw:Pig153Rv	AGCGTGTTGTGAAATGCCGCGG	TGGTGTTCCTCCTAATATCTAC
Pig39Fw:Pig154Rv	AGCGTGTTGTGAAATGCCGCGG	TATCTATGCATTTCACCGCTAC
Pig39Fw:Pig155Rv	AGCGTGTTGTGAAATGCCGCGG	TATCTAAGCATTTCACCGCTAC
Pig39Fw:Pig156Rv	AGCGTGTTGTGAAATGCCGCGG	GTTCAGACTTCCGTCCATTGAC
Pig39Fw:Pig157Rv	AGCGTGTTGTGAAATGCCGCGG	GTTCAGACTTACGTCCATTGAC
Pig39Fw:Pig158Rv	AGCGTGTTGTGAAATGCCGCGG	ACGCTACTTGGCTGGTTCAGAC
Pig39Fw:Pig159Rv	AGCGTGTTGTGAAATGCCGCGG	TCTATGCATTTCACCGCTACAC
Pig39Fw:Pig160Rv	AGCGTGTTGTGAAATGCCGCGG	TCTAAGCATTTCACCGCTACAC
Pig39Fw:Pig161Rv	AGCGTGTTGTGAAATGCCGCGG	ACACCCAGTAAATCCGGACAAC
Pig39Fw:Pig162Rv	AGCGTGTTGTGAAATGCCGCGG	CCGGCCTACGCTCCCTTTAAAC
Pig39Fw:Pig163Rv	AGCGTGTTGTGAAATGCCGCGG	ACGGCCTACGCTCCCTTTAAAC
Pig39Fw:Pig164Rv	AGCGTGTTGTGAAATGCCGCGG	AAGCCGGCCTACGCTCCCTTTA
Pig39Fw:Pig165Rv	AGCGTGTTGTGAAATGCCGCGG	GCGGCATTTCACAACACGCTTA
Pig39Fw:Pig166Rv	AGCGTGTTGTGAAATGCCGCGG	GCACGGAATTAGCCGGTCCTTA
Pig39Fw:Pig167Rv	AGCGTGTTGTGAAATGCCGCGG	AACGCTCGCATCCTCCGTATTA
Pig39Fw:Pig168Rv	AGCGTGTTGTGAAATGCCGCGG	AACGCTTGCCACCTACGTATTA
Pig39Fw:Pig169Rv	AGCGTGTTGTGAAATGCCGCGG	AACGCTCGCCACCTACGTATTA
Pig39Fw:Pig170Rv	AGCGTGTTGTGAAATGCCGCGG	GATAACGCTCGCATCCTCCGTA
Pig39Fw:Pig171Rv	AGCGTGTTGTGAAATGCCGCGG	GACAACGCTTGCCACCTACGTA
Pig39Fw:Pig172Rv	AGCGTGTTGTGAAATGCCGCGG	TCGGAGTTCTTCGTGATATCTA
Pig39Fw:Pig173Rv	AGCGTGTTGTGAAATGCCGCGG	CTGGTGTTCCTCCTAATATCTA
Pig39Fw:Pig174Rv	AGCGTGTTGTGAAATGCCGCGG	ATATCTACGCATTTCACCGCTA
Pig39Fw:Pig175Rv	AGCGTGTTGTGAAATGCCGCGG	TTCGCCACTGGTGTTCCTCCTA
Pig39Fw:Pig176Rv	AGCGTGTTGTGAAATGCCGCGG	GCTACACCACGAATTCCGCCTA
Pig39Fw:Pig177Rv	AGCGTGTTGTGAAATGCCGCGG	TCCGGACAACGCTTGCCACCTA
Pig39Fw:Pig178Rv	AGCGTGTTGTGAAATGCCGCGG	TACGCATTTCACCGCTACACTA
Pig39Fw:Pig179Rv	AGCGTGTTGTGAAATGCCGCGG	GCAATCGGAGTTCTTCGTGATA
Pig39Fw:Pig180Rv	AGCGTGTTGTGAAATGCCGCGG	GCCACTGGTGTTCCTCCTAATA
Pig39Fw:Pig181Rv	AGCGTGTTGTGAAATGCCGCGG	TACGCTCCCTTTAAACCCAATA
Pig39Fw:Pig182Rv	AGCGTGTTGTGAAATGCCGCGG	GGTTCAGACTTCCGTCCATTGA
Pig39Fw:Pig183Rv	AGCGTGTTGTGAAATGCCGCGG	GGTTCAGACTTACGTCCATTGA
Pig39Fw:Pig184Rv	AGCGTGTTGTGAAATGCCGCGG	TCGCAATCGGAGTTCTTCGTGA
Pig39Fw:Pig185Rv	AGCGTGTTGTGAAATGCCGCGG	GTAAGCTGCCTTCGCAATCGGA
Pig39Fw:Pig186Rv	AGCGTGTTGTGAAATGCCGCGG	GCATTTCACCGCTACACTAGGA
Pig39Fw:Pig187Rv	AGCGTGTTGTGAAATGCCGCGG	CACGCTACTTGGCTGGTTCAGA
Pig39Fw:Pig188Rv	AGCGTGTTGTGAAATGCCGCGG	TGCACGCTACTTGGCTGGTTCA
Pig39Fw:Pig189Rv	AGCGTGTTGTGAAATGCCGCGG	ATACCCGCACTTTCGAGCTTCA
Pig39Fw:Pig190Rv	AGCGTGTTGTGAAATGCCGCGG	GCACTTTCGAGCTTCAGCGTCA
Pig39Fw:Pig191Rv	AGCGTGTTGTGAAATGCCGCGG	TTTACAACCCATAGGGCCGTCA
Pig39Fw:Pig192Rv	AGCGTGTTGTGAAATGCCGCGG	CCTTATTCATGCGGTACCTGCA
Pig39Fw:Pig193Rv	AGCGTGTTGTGAAATGCCGCGG	GCTACGGTAAGCTGCCTTCGCA
Pig39Fw:Pig194Rv	AGCGTGTTGTGAAATGCCGCGG	TGTTCCTCCTAATATCTACGCA
Pig39Fw:Pig195Rv	AGCGTGTTGTGAAATGCCGCGG	GGCTGGTTCAGACTTCCGTCCA
Pig39Fw:Pig196Rv	AGCGTGTTGTGAAATGCCGCGG	GGCTGGTTCAGACTTACGTCCA
Pig39Fw:Pig197Rv	AGCGTGTTGTGAAATGCCGCGG	GCCTACGCTCCCTTTAAACCCA
Pig39Fw:Pig198Rv	AGCGTGTTGTGAAATGCCGCGG	TCAGACTTCCGTCCATTGACCA
Pig39Fw:Pig199Rv	AGCGTGTTGTGAAATGCCGCGG	TCAGACTTACGTCCATTGACCA
Pig39Fw:Pig200Rv	AGCGTGTTGTGAAATGCCGCGG	ATCTATGCATTTCACCGCTACA
Pig39Fw:Pig201Rv	AGCGTGTTGTGAAATGCCGCGG	ATCTAAGCATTTCACCGCTACA
Pig39Fw:Pig202Rv	AGCGTGTTGTGAAATGCCGCGG	AGCCGGCCTACGCTCCCTTTAA
Pig39Fw:Pig203Rv	AGCGTGTTGTGAAATGCCGCGG	CGGCATTTCACAACACGCTTAA
Pig39Fw:Pig204Rv	AGCGTGTTGTGAAATGCCGCGG	CGGAGTTCTTCGTGATATCTAA
Pig39Fw:Pig205Rv	AGCGTGTTGTGAAATGCCGCGG	TCGCCACTGGTGTTCCTCCTAA
Pig39Fw:Pig206Rv	AGCGTGTTGTGAAATGCCGCGG	ACGCTCCCTTTAAACCCAATAA
Pig39Fw:Pig207Rv	AGCGTGTTGTGAAATGCCGCGG	CATTTCACCGCTACACTAGGAA
Pig39Fw:Pig208Rv	AGCGTGTTGTGAAATGCCGCGG	CTTATTCATGCGGTACCTGCAA
Pig39Fw:Pig209Rv	AGCGTGTTGTGAAATGCCGCGG	CTACGGTAAGCTGCCTTCGCAA
Pig39Fw:Pig210Rv	AGCGTGTTGTGAAATGCCGCGG	CCTACGCTCCCTTTAAACCCAA
Pig39Fw:Pig211Rv	AGCGTGTTGTGAAATGCCGCGG	CAGACTTCCGTCCATTGACCAA
Pig39Fw:Pig212Rv	AGCGTGTTGTGAAATGCCGCGG	CAGACTTACGTCCATTGACCAA
Pig39Fw:Pig213Rv	AGCGTGTTGTGAAATGCCGCGG	TACACCCAGTAAATCCGGACAA
Pig39Fw:Pig214Rv	AGCGTGTTGTGAAATGCCGCGG	GCCGGCCTACGCTCCCTTTAAA
Pig39Fw:Pig215Rv	AGCGTGTTGTGAAATGCCGCGG	GGCATTTCACAACACGCTTAAA
Pig39Fw:Pig216Rv	AGCGTGTTGTGAAATGCCGCGG	TTATTCATGCGGTACCTGCAAA
Pig39Fw:Pig217Rv	AGCGTGTTGTGAAATGCCGCGG	GCACGGAGTTAGCCGATGCTTT
Pig39Fw:Pig218Rv	AGCGTGTTGTGAAATGCCGCGG	CCTTCACGCGACTTGGCTGGTT
Pig39Fw:Pig219Rv	AGCGTGTTGTGAAATGCCGCGG	ACGGAGTTAGCCGATGCTTATT
Pig39Fw:Pig220Rv	AGCGTGTTGTGAAATGCCGCGG	CAACGCTCGCCACCTACGTATT
Pig39Fw:Pig221Rv	AGCGTGTTGTGAAATGCCGCGG	TTTCACCGCTACACAACGCATT
Pig39Fw:Pig222Rv	AGCGTGTTGTGAAATGCCGCGG	CTGGTTCAGGCTCTCGCCCATT
Pig39Fw:Pig223Rv	AGCGTGTTGTGAAATGCCGCGG	TTTCACCGCTACACGACGAATT
Pig39Fw:Pig224Rv	AGCGTGTTGTGAAATGCCGCGG	TCCTTCACGCGACTTGGCTGGT
Pig39Fw:Pig225Rv	AGCGTGTTGTGAAATGCCGCGG	ATCGGAGTTCTGCGTCATATCT
Pig39Fw:Pig226Rv	AGCGTGTTGTGAAATGCCGCGG	TCGTCCTGCACGCTACTTGGCT
Pig39Fw:Pig227Rv	AGCGTGTTGTGAAATGCCGCGG	CCCAGTAATTCCGGACAACGCT
Pig39Fw:Pig228Rv	AGCGTGTTGTGAAATGCCGCGG	ATCCGGACAACGCTTGCCACCT
Pig39Fw:Pig229Rv	AGCGTGTTGTGAAATGCCGCGG	CACGGAGTTAGCCGATGCTTAT
Pig39Fw:Pig230Rv	AGCGTGTTGTGAAATGCCGCGG	ACAACGCTCGCCACCTACGTAT
Pig39Fw:Pig231Rv	AGCGTGTTGTGAAATGCCGCGG	CGGAGTTCTGCGTCATATCTAT
Pig39Fw:Pig232Rv	AGCGTGTTGTGAAATGCCGCGG	CAATCGGAGTTCTGCGTCATAT
Pig39Fw:Pig233Rv	AGCGTGTTGTGAAATGCCGCGG	ATTTCACCGCTACACAACGCAT
Pig39Fw:Pig234Rv	AGCGTGTTGTGAAATGCCGCGG	ATTTCACCGCTACACGACGAAT
Pig39Fw:Pig235Rv	AGCGTGTTGTGAAATGCCGCGG	TGGTTCAGGCTCTCGCCCATTG
Pig39Fw:Pig236Rv	AGCGTGTTGTGAAATGCCGCGG	AAAGAGGTTTACAATCCGTAGG
Pig39Fw:Pig237Rv	AGCGTGTTGTGAAATGCCGCGG	CACGCTACTTGGCTGGTTCAGG
Pig39Fw:Pig238Rv	AGCGTGTTGTGAAATGCCGCGG	CACCGCTACACAACGCATTCCG
Pig39Fw:Pig239Rv	AGCGTGTTGTGAAATGCCGCGG	CCCTTTACGCCCAATAATTCCG
Pig39Fw:Pig240Rv	AGCGTGTTGTGAAATGCCGCGG	CACCGCTACACGACGAATTCCG
Pig39Fw:Pig241Rv	AGCGTGTTGTGAAATGCCGCGG	GTCATATCTAAGCATTTCACCG
Pig39Fw:Pig242Rv	AGCGTGTTGTGAAATGCCGCGG	AGCATTTCACCGCTACACGACG
Pig39Fw:Pig243Rv	AGCGTGTTGTGAAATGCCGCGG	CTAAGCATTTCACCGCTACACG
Pig39Fw:Pig244Rv	AGCGTGTTGTGAAATGCCGCGG	CACCCAGTAATTCCGGACAACG
Pig39Fw:Pig245Rv	AGCGTGTTGTGAAATGCCGCGG	TGCATTTCACCGCTACACAACG
Pig39Fw:Pig246Rv	AGCGTGTTGTGAAATGCCGCGG	CAAGCTGCCTTCGCAATCGGAG
Pig39Fw:Pig247Rv	AGCGTGTTGTGAAATGCCGCGG	CTTCACGCGACTTGGCTGGTTC
Pig39Fw:Pig248Rv	AGCGTGTTGTGAAATGCCGCGG	CGGAGTTAGCCGATGCTTATTC
Pig39Fw:Pig249Rv	AGCGTGTTGTGAAATGCCGCGG	TTCACCGCTACACAACGCATTC
Pig39Fw:Pig250Rv	AGCGTGTTGTGAAATGCCGCGG	TTCACCGCTACACGACGAATTC
Pig39Fw:Pig251Rv	AGCGTGTTGTGAAATGCCGCGG	AATCGGAGTTCTGCGTCATATC
Pig39Fw:Pig252Rv	AGCGTGTTGTGAAATGCCGCGG	ACGCTACTTGGCTGGTTCAGGC
Pig39Fw:Pig253Rv	AGCGTGTTGTGAAATGCCGCGG	TCATATCTAAGCATTTCACCGC
Pig39Fw:Pig254Rv	AGCGTGTTGTGAAATGCCGCGG	ACCCAGTAATTCCGGACAACGC
Pig39Fw:Pig255Rv	AGCGTGTTGTGAAATGCCGCGG	GCATTTCACCGCTACACAACGC
Pig39Fw:Pig256Rv	AGCGTGTTGTGAAATGCCGCGG	TCACCGCTACACAACGCATTCC
Pig39Fw:Pig257Rv	AGCGTGTTGTGAAATGCCGCGG	TCACCGCTACACGACGAATTCC
Pig39Fw:Pig258Rv	AGCGTGTTGTGAAATGCCGCGG	GTAAATCCGGACAACGCTTGCC
Pig39Fw:Pig259Rv	AGCGTGTTGTGAAATGCCGCGG	TTCAGGCTCTCGCCCATTGACC
Pig39Fw:Pig260Rv	AGCGTGTTGTGAAATGCCGCGG	GAGGTTTACAATCCGTAGGACC
Pig39Fw:Pig261Rv	AGCGTGTTGTGAAATGCCGCGG	CGTCATATCTAAGCATTTCACC
Pig39Fw:Pig262Rv	AGCGTGTTGTGAAATGCCGCGG	AATCCGGACAACGCTTGCCACC
Pig39Fw:Pig263Rv	AGCGTGTTGTGAAATGCCGCGG	CCGCCTACGCACCCTTTAAACC
Pig39Fw:Pig264Rv	AGCGTGTTGTGAAATGCCGCGG	GTTCAGGCTCTCGCCCATTGAC
Pig39Fw:Pig265Rv	AGCGTGTTGTGAAATGCCGCGG	AGAGGTTTACAATCCGTAGGAC
Pig39Fw:Pig266Rv	AGCGTGTTGTGAAATGCCGCGG	AAGCATTTCACCGCTACACGAC
Pig39Fw:Pig267Rv	AGCGTGTTGTGAAATGCCGCGG	AAATCCGGACAACGCTTGCCAC
Pig39Fw:Pig268Rv	AGCGTGTTGTGAAATGCCGCGG	AATTCCGGACAACGCTCGCCAC
Pig39Fw:Pig269Rv	AGCGTGTTGTGAAATGCCGCGG	ACACCCAGTAATTCCGGACAAC
Pig39Fw:Pig270Rv	AGCGTGTTGTGAAATGCCGCGG	ATGCATTTCACCGCTACACAAC
Pig39Fw:Pig271Rv	AGCGTGTTGTGAAATGCCGCGG	GCACGGAGTTAGCCGATGCTTA
Pig39Fw:Pig272Rv	AGCGTGTTGTGAAATGCCGCGG	GACAACGCTCGCCACCTACGTA
Pig39Fw:Pig273Rv	AGCGTGTTGTGAAATGCCGCGG	TCGGAGTTCTGCGTCATATCTA
Pig39Fw:Pig274Rv	AGCGTGTTGTGAAATGCCGCGG	GCAATCGGAGTTCTGCGTCATA
Pig39Fw:Pig275Rv	AGCGTGTTGTGAAATGCCGCGG	GGTTCAGGCTCTCGCCCATTGA
Pig39Fw:Pig276Rv	AGCGTGTTGTGAAATGCCGCGG	CTTTACGCCCAATAATTCCGGA
Pig39Fw:Pig277Rv	AGCGTGTTGTGAAATGCCGCGG	AAGAGGTTTACAATCCGTAGGA
Pig39Fw:Pig278Rv	AGCGTGTTGTGAAATGCCGCGG	GCATTTCACCGCTACACGACGA
Pig39Fw:Pig279Rv	AGCGTGTTGTGAAATGCCGCGG	TAAGCATTTCACCGCTACACGA
Pig39Fw:Pig280Rv	AGCGTGTTGTGAAATGCCGCGG	CTCACGCGACTTGGCTGGTTCA
Pig39Fw:Pig281Rv	AGCGTGTTGTGAAATGCCGCGG	CATTTCACCGCTACACAACGCA
Pig39Fw:Pig282Rv	AGCGTGTTGTGAAATGCCGCGG	TAAATCCGGACAACGCTTGCCA
Pig39Fw:Pig283Rv	AGCGTGTTGTGAAATGCCGCGG	TAATTCCGGACAACGCTCGCCA
Pig39Fw:Pig284Rv	AGCGTGTTGTGAAATGCCGCGG	TCAGGCTCTCGCCCATTGACCA
Pig39Fw:Pig285Rv	AGCGTGTTGTGAAATGCCGCGG	CTATGCATTTCACCGCTACACA
Pig39Fw:Pig286Rv	AGCGTGTTGTGAAATGCCGCGG	CATTTCACCGCTACACGACGAA
Pig39Fw:Pig287Rv	AGCGTGTTGTGAAATGCCGCGG	CAGGCTCTCGCCCATTGACCAA
Pig39Fw:Pig288Rv	AGCGTGTTGTGAAATGCCGCGG	TACACCCAGTAATTCCGGACAA
Pig39Fw:Pig289Rv	AGCGTGTTGTGAAATGCCGCGG	TATGCATTTCACCGCTACACAA
Pig45Fw:Pig1Rv	AGGTACCGCATGAATAAGGACC	CCTGCACGCTACTTGGCTGGTT
Pig45Fw:Pig2Rv	AGGTACCGCATGAATAAGGACC	AGCTGCCTTCGCAATCGGAGTT
Pig45Fw:Pig3Rv	AGGTACCGCATGAATAAGGACC	TGCCTTCGCAATCGGAGTTCTT
Pig45Fw:Pig4Rv	AGGTACCGCATGAATAAGGACC	GGCACGGAGTTAGCCGATGCTT
Pig45Fw:Pig5Rv	AGGTACCGCATGAATAAGGACC	CGCGGCATTTCACAACACGCTT
Pig45Fw:Pig6Rv	AGGTACCGCATGAATAAGGACC	CCAGTAAATCCGGACAACGCTT
Pig45Fw:Pig7Rv	AGGTACCGCATGAATAAGGACC	CGATACCCGCACTTTCGAGCTT
Pig45Fw:Pig8Rv	AGGTACCGCATGAATAAGGACC	GGCACGGAATTAGCCGGTCCTT
Pig45Fw:Pig9Rv	AGGTACCGCATGAATAAGGACC	TAACGCTACGGTAAGCTGCCTT
Pig45Fw:Pig10Rv	AGGTACCGCATGAATAAGGACC	GCCGTCATCCTGCACGCTACTT
Pig45Fw:Pig11Rv	AGGTACCGCATGAATAAGGACC	ACGGAATTAGCCGGTCCTTATT
Pig45Fw:Pig12Rv	AGGTACCGCATGAATAAGGACC	TAACGCTCGCATCCTCCGTATT
Pig45Fw:Pig13Rv	AGGTACCGCATGAATAAGGACC	CAACGCTTGCCACCTACGTATT
Pig45Fw:Pig14Rv	AGGTACCGCATGAATAAGGACC	CTGGTTCAGACTTCCGTCCATT
Pig45Fw:Pig15Rv	AGGTACCGCATGAATAAGGACC	CTGGTTCAGACTTACGTCCATT
Pig45Fw:Pig16Rv	AGGTACCGCATGAATAAGGACC	TTTCACCGCTACACTAGGAATT
Pig45Fw:Pig17Rv	AGGTACCGCATGAATAAGGACC	TCCTGCACGCTACTTGGCTGGT
Pig45Fw:Pig18Rv	AGGTACCGCATGAATAAGGACC	TGCTGGCACGGAATTAGCCGGT
Pig45Fw:Pig19Rv	AGGTACCGCATGAATAAGGACC	CCGCACTTTCGAGCTTCAGCGT
Pig45Fw:Pig20Rv	AGGTACCGCATGAATAAGGACC	CTTGGCTGGTTCAGACTTCCGT
Pig45Fw:Pig21Rv	AGGTACCGCATGAATAAGGACC	AGTTTACAACCCATAGGGCCGT
Pig45Fw:Pig22Rv	AGGTACCGCATGAATAAGGACC	CTGCTGGCACGTAGTTAGCCGT
Pig45Fw:Pig23Rv	AGGTACCGCATGAATAAGGACC	CTTGGCTGGTTCAGACTTACGT
Pig45Fw:Pig24Rv	AGGTACCGCATGAATAAGGACC	GGACAACGCTTGCCACCTACGT
Pig45Fw:Pig25Rv	AGGTACCGCATGAATAAGGACC	AAGCTGCCTTCGCAATCGGAGT
Pig45Fw:Pig26Rv	AGGTACCGCATGAATAAGGACC	CTGCCTTCGCAATCGGAGTTCT
Pig45Fw:Pig27Rv	AGGTACCGCATGAATAAGGACC	ATCGGAGTTCTTCGTGATATCT
Pig45Fw:Pig28Rv	AGGTACCGCATGAATAAGGACC	ACTGGTGTTCCTCCTAATATCT
Pig45Fw:Pig29Rv	AGGTACCGCATGAATAAGGACC	CTTCCGTATTACCGCGGCTGCT
Pig45Fw:Pig30Rv	AGGTACCGCATGAATAAGGACC	CCTACGTATTACCGCGGCTGCT
Pig45Fw:Pig31Rv	AGGTACCGCATGAATAAGGACC	TGGCACGGAGTTAGCCGATGCT
Pig45Fw:Pig32Rv	AGGTACCGCATGAATAAGGACC	TCATCCTGCACGCTACTTGGCT
Pig45Fw:Pig33Rv	AGGTACCGCATGAATAAGGACC	GACCTTCCGTATTACCGCGGCT
Pig45Fw:Pig34Rv	AGGTACCGCATGAATAAGGACC	CATCCTCCGTATTACCGCGGCT
Pig45Fw:Pig35Rv	AGGTACCGCATGAATAAGGACC	CCACCTACGTATTACCGCGGCT
Pig45Fw:Pig36Rv	AGGTACCGCATGAATAAGGACC	AATATCTACGCATTTCACCGCT
Pig45Fw:Pig37Rv	AGGTACCGCATGAATAAGGACC	GATATCTAAGCATTTCACCGCT
Pig45Fw:Pig38Rv	AGGTACCGCATGAATAAGGACC	CATATCTAAGCATTTCACCGCT
Pig45Fw:Pig39Rv	AGGTACCGCATGAATAAGGACC	CCGCGGCATTTCACAACACGCT
Pig45Fw:Pig40Rv	AGGTACCGCATGAATAAGGACC	CCCAGTAAATCCGGACAACGCT
Pig45Fw:Pig41Rv	AGGTACCGCATGAATAAGGACC	TGGCACGGAATTAGCCGGTCCT
Pig45Fw:Pig42Rv	AGGTACCGCATGAATAAGGACC	CTTCGCCACTGGTGTTCCTCCT
Pig45Fw:Pig43Rv	AGGTACCGCATGAATAAGGACC	CAACCCATAGGGCCGTCATCCT
Pig45Fw:Pig44Rv	AGGTACCGCATGAATAAGGACC	CGCTACACCACGAATTCCGCCT
Pig45Fw:Pig45Rv	AGGTACCGCATGAATAAGGACC	GGTCCTTATTCATGCGGTACCT
Pig45Fw:Pig46Rv	AGGTACCGCATGAATAAGGACC	ACACCACGAATTCCGCCTACCT
Pig45Fw:Pig47Rv	AGGTACCGCATGAATAAGGACC	CGCTACTTGGCTGGTTCAGACT
Pig45Fw:Pig48Rv	AGGTACCGCATGAATAAGGACC	CACGGAATTAGCCGGTCCTTAT
Pig45Fw:Pig49Rv	AGGTACCGCATGAATAAGGACC	ATAACGCTCGCATCCTCCGTAT
Pig45Fw:Pig50Rv	AGGTACCGCATGAATAAGGACC	ACAACGCTTGCCACCTACGTAT
Pig45Fw:Pig51Rv	AGGTACCGCATGAATAAGGACC	CAATCGGAGTTCTTCGTGATAT
Pig45Fw:Pig52Rv	AGGTACCGCATGAATAAGGACC	CCACTGGTGTTCCTCCTAATAT
Pig45Fw:Pig53Rv	AGGTACCGCATGAATAAGGACC	CGCAATCGGAGTTCTTCGTGAT
Pig45Fw:Pig54Rv	AGGTACCGCATGAATAAGGACC	TGCTGGCACGGAGTTAGCCGAT
Pig45Fw:Pig55Rv	AGGTACCGCATGAATAAGGACC	TTACAACCCATAGGGCCGTCAT
Pig45Fw:Pig56Rv	AGGTACCGCATGAATAAGGACC	GTTCCTCCTAATATCTACGCAT
Pig45Fw:Pig57Rv	AGGTACCGCATGAATAAGGACC	GCTGGTTCAGACTTCCGTCCAT
Pig45Fw:Pig58Rv	AGGTACCGCATGAATAAGGACC	GCTGGTTCAGACTTACGTCCAT
Pig45Fw:Pig59Rv	AGGTACCGCATGAATAAGGACC	CGCCACTGGTGTTCCTCCTAAT
Pig45Fw:Pig60Rv	AGGTACCGCATGAATAAGGACC	ATTTCACCGCTACACTAGGAAT
Pig45Fw:Pig61Rv	AGGTACCGCATGAATAAGGACC	TACGGTAAGCTGCCTTCGCAAT
Pig45Fw:Pig62Rv	AGGTACCGCATGAATAAGGACC	CTACGCTCCCTTTAAACCCAAT
Pig45Fw:Pig63Rv	AGGTACCGCATGAATAAGGACC	CAGTAAATCCGGACAACGCTTG
Pig45Fw:Pig64Rv	AGGTACCGCATGAATAAGGACC	CCGTCATCCTGCACGCTACTTG
Pig45Fw:Pig65Rv	AGGTACCGCATGAATAAGGACC	TGGTTCAGACTTCCGTCCATTG
Pig45Fw:Pig66Rv	AGGTACCGCATGAATAAGGACC	TGGTTCAGACTTACGTCCATTG
Pig45Fw:Pig67Rv	AGGTACCGCATGAATAAGGACC	TGCCTTCGCAATCGGAGTTCTG
Pig45Fw:Pig68Rv	AGGTACCGCATGAATAAGGACC	TTCCGTATTACCGCGGCTGCTG
Pig45Fw:Pig69Rv	AGGTACCGCATGAATAAGGACC	CTACGTATTACCGCGGCTGCTG
Pig45Fw:Pig70Rv	AGGTACCGCATGAATAAGGACC	CATCCTGCACGCTACTTGGCTG
Pig45Fw:Pig71Rv	AGGTACCGCATGAATAAGGACC	ACCTTCCGTATTACCGCGGCTG
Pig45Fw:Pig72Rv	AGGTACCGCATGAATAAGGACC	ATCCTCCGTATTACCGCGGCTG
Pig45Fw:Pig73Rv	AGGTACCGCATGAATAAGGACC	CACCTACGTATTACCGCGGCTG
Pig45Fw:Pig74Rv	AGGTACCGCATGAATAAGGACC	AACCCATAGGGCCGTCATCCTG
Pig45Fw:Pig75Rv	AGGTACCGCATGAATAAGGACC	GTCCTTATTCATGCGGTACCTG
Pig45Fw:Pig76Rv	AGGTACCGCATGAATAAGGACC	AATTAGCCGGTCCTTATTCATG
Pig45Fw:Pig77Rv	AGGTACCGCATGAATAAGGACC	CGTCATCCTGCACGCTACTTGG
Pig45Fw:Pig78Rv	AGGTACCGCATGAATAAGGACC	TACGTATTACCGCGGCTGCTGG
Pig45Fw:Pig79Rv	AGGTACCGCATGAATAAGGACC	ATCCTGCACGCTACTTGGCTGG
Pig45Fw:Pig80Rv	AGGTACCGCATGAATAAGGACC	AAGCAGTTTACAACCCATAGGG
Pig45Fw:Pig81Rv	AGGTACCGCATGAATAAGGACC	GGTAAGCTGCCTTCGCAATCGG
Pig45Fw:Pig82Rv	AGGTACCGCATGAATAAGGACC	TAGCCGGTCCTTATTCATGCGG
Pig45Fw:Pig83Rv	AGGTACCGCATGAATAAGGACC	TGCCACCTACGTATTACCGCGG
Pig45Fw:Pig84Rv	AGGTACCGCATGAATAAGGACC	CGCATTTCACCGCTACACTAGG
Pig45Fw:Pig85Rv	AGGTACCGCATGAATAAGGACC	AAAGCAGTTTACAACCCATAGG
Pig45Fw:Pig86Rv	AGGTACCGCATGAATAAGGACC	ACGCTACGGTAAGCTGCCTTCG
Pig45Fw:Pig87Rv	AGGTACCGCATGAATAAGGACC	CGGTAAGCTGCCTTCGCAATCG
Pig45Fw:Pig88Rv	AGGTACCGCATGAATAAGGACC	TTAGCCGGTCCTTATTCATGCG
Pig45Fw:Pig89Rv	AGGTACCGCATGAATAAGGACC	TCGCATCCTCCGTATTACCGCG
Pig45Fw:Pig90Rv	AGGTACCGCATGAATAAGGACC	TTGCCACCTACGTATTACCGCG
Pig45Fw:Pig91Rv	AGGTACCGCATGAATAAGGACC	TCGCCACCTACGTATTACCGCG
Pig45Fw:Pig92Rv	AGGTACCGCATGAATAAGGACC	CAGTTTACAACCCATAGGGCCG
Pig45Fw:Pig93Rv	AGGTACCGCATGAATAAGGACC	GCTCGCATCCTCCGTATTACCG
Pig45Fw:Pig94Rv	AGGTACCGCATGAATAAGGACC	GCTTGCCACCTACGTATTACCG
Pig45Fw:Pig95Rv	AGGTACCGCATGAATAAGGACC	GCTCGCCACCTACGTATTACCG
Pig45Fw:Pig96Rv	AGGTACCGCATGAATAAGGACC	CTAATATCTACGCATTTCACCG
Pig45Fw:Pig97Rv	AGGTACCGCATGAATAAGGACC	GGTGTTCCTCCTAATATCTACG
Pig45Fw:Pig98Rv	AGGTACCGCATGAATAAGGACC	CACCCAGTAAATCCGGACAACG
Pig45Fw:Pig99Rv	AGGTACCGCATGAATAAGGACC	ACGCATTTCACCGCTACACTAG
Pig45Fw:Pig100Rv	AGGTACCGCATGAATAAGGACC	TAAGCTGCCTTCGCAATCGGAG
Pig45Fw:Pig101Rv	AGGTACCGCATGAATAAGGACC	GCACGCTACTTGGCTGGTTCAG
Pig45Fw:Pig102Rv	AGGTACCGCATGAATAAGGACC	TCACGCGACTTGGCTGGTTCAG
Pig45Fw:Pig103Rv	AGGTACCGCATGAATAAGGACC	TACCCGCACTTTCGAGCTTCAG
Pig45Fw:Pig104Rv	AGGTACCGCATGAATAAGGACC	GGAGTTCTTCGTGATATCTAAG
Pig45Fw:Pig105Rv	AGGTACCGCATGAATAAGGACC	CCTCCTAATATCTACGCATTTC
Pig45Fw:Pig106Rv	AGGTACCGCATGAATAAGGACC	CTGCACGCTACTTGGCTGGTTC
Pig45Fw:Pig107Rv	AGGTACCGCATGAATAAGGACC	GCTGCCTTCGCAATCGGAGTTC
Pig45Fw:Pig108Rv	AGGTACCGCATGAATAAGGACC	GATACCCGCACTTTCGAGCTTC
Pig45Fw:Pig109Rv	AGGTACCGCATGAATAAGGACC	AACGCTACGGTAAGCTGCCTTC
Pig45Fw:Pig110Rv	AGGTACCGCATGAATAAGGACC	TTCACCGCTACACTAGGAATTC
Pig45Fw:Pig111Rv	AGGTACCGCATGAATAAGGACC	CGCACTTTCGAGCTTCAGCGTC
Pig45Fw:Pig112Rv	AGGTACCGCATGAATAAGGACC	TTGGCTGGTTCAGACTTCCGTC
Pig45Fw:Pig113Rv	AGGTACCGCATGAATAAGGACC	GTTTACAACCCATAGGGCCGTC
Pig45Fw:Pig114Rv	AGGTACCGCATGAATAAGGACC	TTGGCTGGTTCAGACTTACGTC
Pig45Fw:Pig115Rv	AGGTACCGCATGAATAAGGACC	CACCACGAATTCCGCCTACCTC
Pig45Fw:Pig116Rv	AGGTACCGCATGAATAAGGACC	AATCGGAGTTCTTCGTGATATC
Pig45Fw:Pig117Rv	AGGTACCGCATGAATAAGGACC	CACTGGTGTTCCTCCTAATATC
Pig45Fw:Pig118Rv	AGGTACCGCATGAATAAGGACC	TACAACCCATAGGGCCGTCATC
Pig45Fw:Pig119Rv	AGGTACCGCATGAATAAGGACC	ACGGTAAGCTGCCTTCGCAATC
Pig45Fw:Pig120Rv	AGGTACCGCATGAATAAGGACC	AGTAAATCCGGACAACGCTTGC
Pig45Fw:Pig121Rv	AGGTACCGCATGAATAAGGACC	GCCTTCGCAATCGGAGTTCTGC
Pig45Fw:Pig122Rv	AGGTACCGCATGAATAAGGACC	ACCTACGTATTACCGCGGCTGC
Pig45Fw:Pig123Rv	AGGTACCGCATGAATAAGGACC	TCCTTATTCATGCGGTACCTGC
Pig45Fw:Pig124Rv	AGGTACCGCATGAATAAGGACC	ATTAGCCGGTCCTTATTCATGC
Pig45Fw:Pig125Rv	AGGTACCGCATGAATAAGGACC	GTCATCCTGCACGCTACTTGGC
Pig45Fw:Pig126Rv	AGGTACCGCATGAATAAGGACC	AGCAGTTTACAACCCATAGGGC
Pig45Fw:Pig127Rv	AGGTACCGCATGAATAAGGACC	CTCGCATCCTCCGTATTACCGC
Pig45Fw:Pig128Rv	AGGTACCGCATGAATAAGGACC	CTTGCCACCTACGTATTACCGC
Pig45Fw:Pig129Rv	AGGTACCGCATGAATAAGGACC	CTCGCCACCTACGTATTACCGC
Pig45Fw:Pig130Rv	AGGTACCGCATGAATAAGGACC	TAATATCTACGCATTTCACCGC
Pig45Fw:Pig131Rv	AGGTACCGCATGAATAAGGACC	TGATATCTAAGCATTTCACCGC
Pig45Fw:Pig132Rv	AGGTACCGCATGAATAAGGACC	GTGTTCCTCCTAATATCTACGC
Pig45Fw:Pig133Rv	AGGTACCGCATGAATAAGGACC	ACCCAGTAAATCCGGACAACGC
Pig45Fw:Pig134Rv	AGGTACCGCATGAATAAGGACC	ACCCGCACTTTCGAGCTTCAGC
Pig45Fw:Pig135Rv	AGGTACCGCATGAATAAGGACC	GAGTTCTTCGTGATATCTAAGC
Pig45Fw:Pig136Rv	AGGTACCGCATGAATAAGGACC	TGGCTGGTTCAGACTTCCGTCC
Pig45Fw:Pig137Rv	AGGTACCGCATGAATAAGGACC	TGGCTGGTTCAGACTTACGTCC
Pig45Fw:Pig138Rv	AGGTACCGCATGAATAAGGACC	ACCACGAATTCCGCCTACCTCC
Pig45Fw:Pig139Rv	AGGTACCGCATGAATAAGGACC	ACAACCCATAGGGCCGTCATCC
Pig45Fw:Pig140Rv	AGGTACCGCATGAATAAGGACC	GCAGTTTACAACCCATAGGGCC
Pig45Fw:Pig141Rv	AGGTACCGCATGAATAAGGACC	GGCCTACGCTCCCTTTAAACCC
Pig45Fw:Pig142Rv	AGGTACCGCATGAATAAGGACC	CGCTCGCATCCTCCGTATTACC
Pig45Fw:Pig143Rv	AGGTACCGCATGAATAAGGACC	CGCTTGCCACCTACGTATTACC
Pig45Fw:Pig144Rv	AGGTACCGCATGAATAAGGACC	CGCTCGCCACCTACGTATTACC
Pig45Fw:Pig145Rv	AGGTACCGCATGAATAAGGACC	TACACCACGAATTCCGCCTACC
Pig45Fw:Pig146Rv	AGGTACCGCATGAATAAGGACC	TTCAGACTTCCGTCCATTGACC
Pig45Fw:Pig147Rv	AGGTACCGCATGAATAAGGACC	TTCAGACTTACGTCCATTGACC
Pig45Fw:Pig148Rv	AGGTACCGCATGAATAAGGACC	CCTAATATCTACGCATTTCACC
Pig45Fw:Pig149Rv	AGGTACCGCATGAATAAGGACC	CGGCCTACGCTCCCTTTAAACC
Pig45Fw:Pig150Rv	AGGTACCGCATGAATAAGGACC	ACGCTCGCATCCTCCGTATTAC
Pig45Fw:Pig151Rv	AGGTACCGCATGAATAAGGACC	ACGCTTGCCACCTACGTATTAC
Pig45Fw:Pig152Rv	AGGTACCGCATGAATAAGGACC	ACGCTCGCCACCTACGTATTAC
Pig45Fw:Pig153Rv	AGGTACCGCATGAATAAGGACC	TGGTGTTCCTCCTAATATCTAC
Pig45Fw:Pig154Rv	AGGTACCGCATGAATAAGGACC	TATCTATGCATTTCACCGCTAC
Pig45Fw:Pig155Rv	AGGTACCGCATGAATAAGGACC	TATCTAAGCATTTCACCGCTAC
Pig45Fw:Pig156Rv	AGGTACCGCATGAATAAGGACC	GTTCAGACTTCCGTCCATTGAC
Pig45Fw:Pig157Rv	AGGTACCGCATGAATAAGGACC	GTTCAGACTTACGTCCATTGAC
Pig45Fw:Pig158Rv	AGGTACCGCATGAATAAGGACC	ACGCTACTTGGCTGGTTCAGAC
Pig45Fw:Pig159Rv	AGGTACCGCATGAATAAGGACC	TCTATGCATTTCACCGCTACAC
Pig45Fw:Pig160Rv	AGGTACCGCATGAATAAGGACC	TCTAAGCATTTCACCGCTACAC
Pig45Fw:Pig161Rv	AGGTACCGCATGAATAAGGACC	ACACCCAGTAAATCCGGACAAC
Pig45Fw:Pig162Rv	AGGTACCGCATGAATAAGGACC	CCGGCCTACGCTCCCTTTAAAC
Pig45Fw:Pig163Rv	AGGTACCGCATGAATAAGGACC	ACGGCCTACGCTCCCTTTAAAC
Pig45Fw:Pig164Rv	AGGTACCGCATGAATAAGGACC	AAGCCGGCCTACGCTCCCTTTA
Pig45Fw:Pig165Rv	AGGTACCGCATGAATAAGGACC	GCGGCATTTCACAACACGCTTA
Pig45Fw:Pig166Rv	AGGTACCGCATGAATAAGGACC	GCACGGAATTAGCCGGTCCTTA
Pig45Fw:Pig167Rv	AGGTACCGCATGAATAAGGACC	AACGCTCGCATCCTCCGTATTA
Pig45Fw:Pig168Rv	AGGTACCGCATGAATAAGGACC	AACGCTTGCCACCTACGTATTA
Pig45Fw:Pig169Rv	AGGTACCGCATGAATAAGGACC	AACGCTCGCCACCTACGTATTA
Pig45Fw:Pig170Rv	AGGTACCGCATGAATAAGGACC	GATAACGCTCGCATCCTCCGTA
Pig45Fw:Pig171Rv	AGGTACCGCATGAATAAGGACC	GACAACGCTTGCCACCTACGTA
Pig45Fw:Pig172Rv	AGGTACCGCATGAATAAGGACC	TCGGAGTTCTTCGTGATATCTA
Pig45Fw:Pig173Rv	AGGTACCGCATGAATAAGGACC	CTGGTGTTCCTCCTAATATCTA
Pig45Fw:Pig174Rv	AGGTACCGCATGAATAAGGACC	ATATCTACGCATTTCACCGCTA
Pig45Fw:Pig175Rv	AGGTACCGCATGAATAAGGACC	TTCGCCACTGGTGTTCCTCCTA
Pig45Fw:Pig176Rv	AGGTACCGCATGAATAAGGACC	GCTACACCACGAATTCCGCCTA
Pig45Fw:Pig177Rv	AGGTACCGCATGAATAAGGACC	TCCGGACAACGCTTGCCACCTA
Pig45Fw:Pig178Rv	AGGTACCGCATGAATAAGGACC	TACGCATTTCACCGCTACACTA
Pig45Fw:Pig179Rv	AGGTACCGCATGAATAAGGACC	GCAATCGGAGTTCTTCGTGATA
Pig45Fw:Pig180Rv	AGGTACCGCATGAATAAGGACC	GCCACTGGTGTTCCTCCTAATA
Pig45Fw:Pig181Rv	AGGTACCGCATGAATAAGGACC	TACGCTCCCTTTAAACCCAATA
Pig45Fw:Pig182Rv	AGGTACCGCATGAATAAGGACC	GGTTCAGACTTCCGTCCATTGA
Pig45Fw:Pig183Rv	AGGTACCGCATGAATAAGGACC	GGTTCAGACTTACGTCCATTGA
Pig45Fw:Pig184Rv	AGGTACCGCATGAATAAGGACC	TCGCAATCGGAGTTCTTCGTGA
Pig45Fw:Pig185Rv	AGGTACCGCATGAATAAGGACC	GTAAGCTGCCTTCGCAATCGGA
Pig45Fw:Pig186Rv	AGGTACCGCATGAATAAGGACC	GCATTTCACCGCTACACTAGGA
Pig45Fw:Pig187Rv	AGGTACCGCATGAATAAGGACC	CACGCTACTTGGCTGGTTCAGA
Pig45Fw:Pig188Rv	AGGTACCGCATGAATAAGGACC	TGCACGCTACTTGGCTGGTTCA
Pig45Fw:Pig189Rv	AGGTACCGCATGAATAAGGACC	ATACCCGCACTTTCGAGCTTCA
Pig45Fw:Pig190Rv	AGGTACCGCATGAATAAGGACC	GCACTTTCGAGCTTCAGCGTCA
Pig45Fw:Pig191Rv	AGGTACCGCATGAATAAGGACC	TTTACAACCCATAGGGCCGTCA
Pig45Fw:Pig192Rv	AGGTACCGCATGAATAAGGACC	CCTTATTCATGCGGTACCTGCA
Pig45Fw:Pig193Rv	AGGTACCGCATGAATAAGGACC	GCTACGGTAAGCTGCCTTCGCA
Pig45Fw:Pig194Rv	AGGTACCGCATGAATAAGGACC	TGTTCCTCCTAATATCTACGCA
Pig45Fw:Pig195Rv	AGGTACCGCATGAATAAGGACC	GGCTGGTTCAGACTTCCGTCCA
Pig45Fw:Pig196Rv	AGGTACCGCATGAATAAGGACC	GGCTGGTTCAGACTTACGTCCA
Pig45Fw:Pig197Rv	AGGTACCGCATGAATAAGGACC	GCCTACGCTCCCTTTAAACCCA
Pig45Fw:Pig198Rv	AGGTACCGCATGAATAAGGACC	TCAGACTTCCGTCCATTGACCA
Pig45Fw:Pig199Rv	AGGTACCGCATGAATAAGGACC	TCAGACTTACGTCCATTGACCA
Pig45Fw:Pig200Rv	AGGTACCGCATGAATAAGGACC	ATCTATGCATTTCACCGCTACA
Pig45Fw:Pig201Rv	AGGTACCGCATGAATAAGGACC	ATCTAAGCATTTCACCGCTACA
Pig45Fw:Pig202Rv	AGGTACCGCATGAATAAGGACC	AGCCGGCCTACGCTCCCTTTAA
Pig45Fw:Pig203Rv	AGGTACCGCATGAATAAGGACC	CGGCATTTCACAACACGCTTAA
Pig45Fw:Pig204Rv	AGGTACCGCATGAATAAGGACC	CGGAGTTCTTCGTGATATCTAA
Pig45Fw:Pig205Rv	AGGTACCGCATGAATAAGGACC	TCGCCACTGGTGTTCCTCCTAA
Pig45Fw:Pig206Rv	AGGTACCGCATGAATAAGGACC	ACGCTCCCTTTAAACCCAATAA
Pig45Fw:Pig207Rv	AGGTACCGCATGAATAAGGACC	CATTTCACCGCTACACTAGGAA
Pig45Fw:Pig208Rv	AGGTACCGCATGAATAAGGACC	CTTATTCATGCGGTACCTGCAA
Pig45Fw:Pig209Rv	AGGTACCGCATGAATAAGGACC	CTACGGTAAGCTGCCTTCGCAA
Pig45Fw:Pig210Rv	AGGTACCGCATGAATAAGGACC	CCTACGCTCCCTTTAAACCCAA
Pig45Fw:Pig211Rv	AGGTACCGCATGAATAAGGACC	CAGACTTCCGTCCATTGACCAA
Pig45Fw:Pig212Rv	AGGTACCGCATGAATAAGGACC	CAGACTTACGTCCATTGACCAA
Pig45Fw:Pig213Rv	AGGTACCGCATGAATAAGGACC	TACACCCAGTAAATCCGGACAA
Pig45Fw:Pig214Rv	AGGTACCGCATGAATAAGGACC	GCCGGCCTACGCTCCCTTTAAA
Pig45Fw:Pig215Rv	AGGTACCGCATGAATAAGGACC	GGCATTTCACAACACGCTTAAA
Pig45Fw:Pig216Rv	AGGTACCGCATGAATAAGGACC	TTATTCATGCGGTACCTGCAAA
Pig45Fw:Pig217Rv	AGGTACCGCATGAATAAGGACC	GCACGGAGTTAGCCGATGCTTT
Pig45Fw:Pig218Rv	AGGTACCGCATGAATAAGGACC	CCTTCACGCGACTTGGCTGGTT
Pig45Fw:Pig219Rv	AGGTACCGCATGAATAAGGACC	ACGGAGTTAGCCGATGCTTATT
Pig45Fw:Pig220Rv	AGGTACCGCATGAATAAGGACC	CAACGCTCGCCACCTACGTATT
Pig45Fw:Pig221Rv	AGGTACCGCATGAATAAGGACC	TTTCACCGCTACACAACGCATT
Pig45Fw:Pig222Rv	AGGTACCGCATGAATAAGGACC	CTGGTTCAGGCTCTCGCCCATT
Pig45Fw:Pig223Rv	AGGTACCGCATGAATAAGGACC	TTTCACCGCTACACGACGAATT
Pig45Fw:Pig224Rv	AGGTACCGCATGAATAAGGACC	TCCTTCACGCGACTTGGCTGGT
Pig45Fw:Pig225Rv	AGGTACCGCATGAATAAGGACC	ATCGGAGTTCTGCGTCATATCT
Pig45Fw:Pig226Rv	AGGTACCGCATGAATAAGGACC	TCGTCCTGCACGCTACTTGGCT
Pig45Fw:Pig227Rv	AGGTACCGCATGAATAAGGACC	CCCAGTAATTCCGGACAACGCT
Pig45Fw:Pig228Rv	AGGTACCGCATGAATAAGGACC	ATCCGGACAACGCTTGCCACCT
Pig45Fw:Pig229Rv	AGGTACCGCATGAATAAGGACC	CACGGAGTTAGCCGATGCTTAT
Pig45Fw:Pig230Rv	AGGTACCGCATGAATAAGGACC	ACAACGCTCGCCACCTACGTAT
Pig45Fw:Pig231Rv	AGGTACCGCATGAATAAGGACC	CGGAGTTCTGCGTCATATCTAT
Pig45Fw:Pig232Rv	AGGTACCGCATGAATAAGGACC	CAATCGGAGTTCTGCGTCATAT
Pig45Fw:Pig233Rv	AGGTACCGCATGAATAAGGACC	ATTTCACCGCTACACAACGCAT
Pig45Fw:Pig234Rv	AGGTACCGCATGAATAAGGACC	ATTTCACCGCTACACGACGAAT
Pig45Fw:Pig235Rv	AGGTACCGCATGAATAAGGACC	TGGTTCAGGCTCTCGCCCATTG
Pig45Fw:Pig236Rv	AGGTACCGCATGAATAAGGACC	AAAGAGGTTTACAATCCGTAGG
Pig45Fw:Pig237Rv	AGGTACCGCATGAATAAGGACC	CACGCTACTTGGCTGGTTCAGG
Pig45Fw:Pig238Rv	AGGTACCGCATGAATAAGGACC	CACCGCTACACAACGCATTCCG
Pig45Fw:Pig239Rv	AGGTACCGCATGAATAAGGACC	CCCTTTACGCCCAATAATTCCG
Pig45Fw:Pig240Rv	AGGTACCGCATGAATAAGGACC	CACCGCTACACGACGAATTCCG
Pig45Fw:Pig241Rv	AGGTACCGCATGAATAAGGACC	GTCATATCTAAGCATTTCACCG
Pig45Fw:Pig242Rv	AGGTACCGCATGAATAAGGACC	AGCATTTCACCGCTACACGACG
Pig45Fw:Pig243Rv	AGGTACCGCATGAATAAGGACC	CTAAGCATTTCACCGCTACACG
Pig45Fw:Pig244Rv	AGGTACCGCATGAATAAGGACC	CACCCAGTAATTCCGGACAACG
Pig45Fw:Pig245Rv	AGGTACCGCATGAATAAGGACC	TGCATTTCACCGCTACACAACG
Pig45Fw:Pig246Rv	AGGTACCGCATGAATAAGGACC	CAAGCTGCCTTCGCAATCGGAG
Pig45Fw:Pig247Rv	AGGTACCGCATGAATAAGGACC	CTTCACGCGACTTGGCTGGTTC
Pig45Fw:Pig248Rv	AGGTACCGCATGAATAAGGACC	CGGAGTTAGCCGATGCTTATTC
Pig45Fw:Pig249Rv	AGGTACCGCATGAATAAGGACC	TTCACCGCTACACAACGCATTC
Pig45Fw:Pig250Rv	AGGTACCGCATGAATAAGGACC	TTCACCGCTACACGACGAATTC
Pig45Fw:Pig251Rv	AGGTACCGCATGAATAAGGACC	AATCGGAGTTCTGCGTCATATC
Pig45Fw:Pig252Rv	AGGTACCGCATGAATAAGGACC	ACGCTACTTGGCTGGTTCAGGC
Pig45Fw:Pig253Rv	AGGTACCGCATGAATAAGGACC	TCATATCTAAGCATTTCACCGC
Pig45Fw:Pig254Rv	AGGTACCGCATGAATAAGGACC	ACCCAGTAATTCCGGACAACGC
Pig45Fw:Pig255Rv	AGGTACCGCATGAATAAGGACC	GCATTTCACCGCTACACAACGC
Pig45Fw:Pig256Rv	AGGTACCGCATGAATAAGGACC	TCACCGCTACACAACGCATTCC
Pig45Fw:Pig257Rv	AGGTACCGCATGAATAAGGACC	TCACCGCTACACGACGAATTCC
Pig45Fw:Pig258Rv	AGGTACCGCATGAATAAGGACC	GTAAATCCGGACAACGCTTGCC
Pig45Fw:Pig259Rv	AGGTACCGCATGAATAAGGACC	TTCAGGCTCTCGCCCATTGACC
Pig45Fw:Pig260Rv	AGGTACCGCATGAATAAGGACC	GAGGTTTACAATCCGTAGGACC
Pig45Fw:Pig261Rv	AGGTACCGCATGAATAAGGACC	CGTCATATCTAAGCATTTCACC
Pig45Fw:Pig262Rv	AGGTACCGCATGAATAAGGACC	AATCCGGACAACGCTTGCCACC
Pig45Fw:Pig263Rv	AGGTACCGCATGAATAAGGACC	CCGCCTACGCACCCTTTAAACC
Pig45Fw:Pig264Rv	AGGTACCGCATGAATAAGGACC	GTTCAGGCTCTCGCCCATTGAC
Pig45Fw:Pig265Rv	AGGTACCGCATGAATAAGGACC	AGAGGTTTACAATCCGTAGGAC
Pig45Fw:Pig266Rv	AGGTACCGCATGAATAAGGACC	AAGCATTTCACCGCTACACGAC
Pig45Fw:Pig267Rv	AGGTACCGCATGAATAAGGACC	AAATCCGGACAACGCTTGCCAC
Pig45Fw:Pig268Rv	AGGTACCGCATGAATAAGGACC	AATTCCGGACAACGCTCGCCAC
Pig45Fw:Pig269Rv	AGGTACCGCATGAATAAGGACC	ACACCCAGTAATTCCGGACAAC
Pig45Fw:Pig270Rv	AGGTACCGCATGAATAAGGACC	ATGCATTTCACCGCTACACAAC
Pig45Fw:Pig271Rv	AGGTACCGCATGAATAAGGACC	GCACGGAGTTAGCCGATGCTTA
Pig45Fw:Pig272Rv	AGGTACCGCATGAATAAGGACC	GACAACGCTCGCCACCTACGTA
Pig45Fw:Pig273Rv	AGGTACCGCATGAATAAGGACC	TCGGAGTTCTGCGTCATATCTA
Pig45Fw:Pig274Rv	AGGTACCGCATGAATAAGGACC	GCAATCGGAGTTCTGCGTCATA
Pig45Fw:Pig275Rv	AGGTACCGCATGAATAAGGACC	GGTTCAGGCTCTCGCCCATTGA
Pig45Fw:Pig276Rv	AGGTACCGCATGAATAAGGACC	CTTTACGCCCAATAATTCCGGA
Pig45Fw:Pig277Rv	AGGTACCGCATGAATAAGGACC	AAGAGGTTTACAATCCGTAGGA
Pig45Fw:Pig278Rv	AGGTACCGCATGAATAAGGACC	GCATTTCACCGCTACACGACGA
Pig45Fw:Pig279Rv	AGGTACCGCATGAATAAGGACC	TAAGCATTTCACCGCTACACGA
Pig45Fw:Pig280Rv	AGGTACCGCATGAATAAGGACC	CTCACGCGACTTGGCTGGTTCA
Pig45Fw:Pig281Rv	AGGTACCGCATGAATAAGGACC	CATTTCACCGCTACACAACGCA
Pig45Fw:Pig282Rv	AGGTACCGCATGAATAAGGACC	TAAATCCGGACAACGCTTGCCA
Pig45Fw:Pig283Rv	AGGTACCGCATGAATAAGGACC	TAATTCCGGACAACGCTCGCCA
Pig45Fw:Pig284Rv	AGGTACCGCATGAATAAGGACC	TCAGGCTCTCGCCCATTGACCA
Pig45Fw:Pig285Rv	AGGTACCGCATGAATAAGGACC	CTATGCATTTCACCGCTACACA
Pig45Fw:Pig286Rv	AGGTACCGCATGAATAAGGACC	CATTTCACCGCTACACGACGAA
Pig45Fw:Pig287Rv	AGGTACCGCATGAATAAGGACC	CAGGCTCTCGCCCATTGACCAA
Pig45Fw:Pig288Rv	AGGTACCGCATGAATAAGGACC	TACACCCAGTAATTCCGGACAA
Pig45Fw:Pig289Rv	AGGTACCGCATGAATAAGGACC	TATGCATTTCACCGCTACACAA
Pig46Fw:Pig1Rv	AGGTAGGCGGAATTCGTGGTGT	CCTGCACGCTACTTGGCTGGTT
Pig46Fw:Pig2Rv	AGGTAGGCGGAATTCGTGGTGT	AGCTGCCTTCGCAATCGGAGTT
Pig46Fw:Pig3Rv	AGGTAGGCGGAATTCGTGGTGT	TGCCTTCGCAATCGGAGTTCTT
Pig46Fw:Pig4Rv	AGGTAGGCGGAATTCGTGGTGT	GGCACGGAGTTAGCCGATGCTT
Pig46Fw:Pig5Rv	AGGTAGGCGGAATTCGTGGTGT	CGCGGCATTTCACAACACGCTT
Pig46Fw:Pig6Rv	AGGTAGGCGGAATTCGTGGTGT	CCAGTAAATCCGGACAACGCTT
Pig46Fw:Pig7Rv	AGGTAGGCGGAATTCGTGGTGT	CGATACCCGCACTTTCGAGCTT
Pig46Fw:Pig8Rv	AGGTAGGCGGAATTCGTGGTGT	GGCACGGAATTAGCCGGTCCTT
Pig46Fw:Pig9Rv	AGGTAGGCGGAATTCGTGGTGT	TAACGCTACGGTAAGCTGCCTT
Pig46Fw:Pig10Rv	AGGTAGGCGGAATTCGTGGTGT	GCCGTCATCCTGCACGCTACTT
Pig46Fw:Pig11Rv	AGGTAGGCGGAATTCGTGGTGT	ACGGAATTAGCCGGTCCTTATT
Pig46Fw:Pig12Rv	AGGTAGGCGGAATTCGTGGTGT	TAACGCTCGCATCCTCCGTATT
Pig46Fw:Pig13Rv	AGGTAGGCGGAATTCGTGGTGT	CAACGCTTGCCACCTACGTATT
Pig46Fw:Pig14Rv	AGGTAGGCGGAATTCGTGGTGT	CTGGTTCAGACTTCCGTCCATT
Pig46Fw:Pig15Rv	AGGTAGGCGGAATTCGTGGTGT	CTGGTTCAGACTTACGTCCATT
Pig46Fw:Pig16Rv	AGGTAGGCGGAATTCGTGGTGT	TTTCACCGCTACACTAGGAATT
Pig46Fw:Pig17Rv	AGGTAGGCGGAATTCGTGGTGT	TCCTGCACGCTACTTGGCTGGT
Pig46Fw:Pig18Rv	AGGTAGGCGGAATTCGTGGTGT	TGCTGGCACGGAATTAGCCGGT
Pig46Fw:Pig19Rv	AGGTAGGCGGAATTCGTGGTGT	CCGCACTTTCGAGCTTCAGCGT
Pig46Fw:Pig20Rv	AGGTAGGCGGAATTCGTGGTGT	CTTGGCTGGTTCAGACTTCCGT
Pig46Fw:Pig21Rv	AGGTAGGCGGAATTCGTGGTGT	AGTTTACAACCCATAGGGCCGT
Pig46Fw:Pig22Rv	AGGTAGGCGGAATTCGTGGTGT	CTGCTGGCACGTAGTTAGCCGT
Pig46Fw:Pig23Rv	AGGTAGGCGGAATTCGTGGTGT	CTTGGCTGGTTCAGACTTACGT
Pig46Fw:Pig24Rv	AGGTAGGCGGAATTCGTGGTGT	GGACAACGCTTGCCACCTACGT
Pig46Fw:Pig25Rv	AGGTAGGCGGAATTCGTGGTGT	AAGCTGCCTTCGCAATCGGAGT
Pig46Fw:Pig26Rv	AGGTAGGCGGAATTCGTGGTGT	CTGCCTTCGCAATCGGAGTTCT
Pig46Fw:Pig27Rv	AGGTAGGCGGAATTCGTGGTGT	ATCGGAGTTCTTCGTGATATCT
Pig46Fw:Pig28Rv	AGGTAGGCGGAATTCGTGGTGT	ACTGGTGTTCCTCCTAATATCT
Pig46Fw:Pig29Rv	AGGTAGGCGGAATTCGTGGTGT	CTTCCGTATTACCGCGGCTGCT
Pig46Fw:Pig30Rv	AGGTAGGCGGAATTCGTGGTGT	CCTACGTATTACCGCGGCTGCT
Pig46Fw:Pig31Rv	AGGTAGGCGGAATTCGTGGTGT	TGGCACGGAGTTAGCCGATGCT
Pig46Fw:Pig32Rv	AGGTAGGCGGAATTCGTGGTGT	TCATCCTGCACGCTACTTGGCT
Pig46Fw:Pig33Rv	AGGTAGGCGGAATTCGTGGTGT	GACCTTCCGTATTACCGCGGCT
Pig46Fw:Pig34Rv	AGGTAGGCGGAATTCGTGGTGT	CATCCTCCGTATTACCGCGGCT
Pig46Fw:Pig35Rv	AGGTAGGCGGAATTCGTGGTGT	CCACCTACGTATTACCGCGGCT
Pig46Fw:Pig36Rv	AGGTAGGCGGAATTCGTGGTGT	AATATCTACGCATTTCACCGCT
Pig46Fw:Pig37Rv	AGGTAGGCGGAATTCGTGGTGT	GATATCTAAGCATTTCACCGCT
Pig46Fw:Pig38Rv	AGGTAGGCGGAATTCGTGGTGT	CATATCTAAGCATTTCACCGCT
Pig46Fw:Pig39Rv	AGGTAGGCGGAATTCGTGGTGT	CCGCGGCATTTCACAACACGCT
Pig46Fw:Pig40Rv	AGGTAGGCGGAATTCGTGGTGT	CCCAGTAAATCCGGACAACGCT
Pig46Fw:Pig41Rv	AGGTAGGCGGAATTCGTGGTGT	TGGCACGGAATTAGCCGGTCCT
Pig46Fw:Pig42Rv	AGGTAGGCGGAATTCGTGGTGT	CTTCGCCACTGGTGTTCCTCCT
Pig46Fw:Pig43Rv	AGGTAGGCGGAATTCGTGGTGT	CAACCCATAGGGCCGTCATCCT
Pig46Fw:Pig44Rv	AGGTAGGCGGAATTCGTGGTGT	CGCTACACCACGAATTCCGCCT
Pig46Fw:Pig45Rv	AGGTAGGCGGAATTCGTGGTGT	GGTCCTTATTCATGCGGTACCT
Pig46Fw:Pig46Rv	AGGTAGGCGGAATTCGTGGTGT	ACACCACGAATTCCGCCTACCT
Pig46Fw:Pig47Rv	AGGTAGGCGGAATTCGTGGTGT	CGCTACTTGGCTGGTTCAGACT
Pig46Fw:Pig48Rv	AGGTAGGCGGAATTCGTGGTGT	CACGGAATTAGCCGGTCCTTAT
Pig46Fw:Pig49Rv	AGGTAGGCGGAATTCGTGGTGT	ATAACGCTCGCATCCTCCGTAT
Pig46Fw:Pig50Rv	AGGTAGGCGGAATTCGTGGTGT	ACAACGCTTGCCACCTACGTAT
Pig46Fw:Pig51Rv	AGGTAGGCGGAATTCGTGGTGT	CAATCGGAGTTCTTCGTGATAT
Pig46Fw:Pig52Rv	AGGTAGGCGGAATTCGTGGTGT	CCACTGGTGTTCCTCCTAATAT
Pig46Fw:Pig53Rv	AGGTAGGCGGAATTCGTGGTGT	CGCAATCGGAGTTCTTCGTGAT
Pig46Fw:Pig54Rv	AGGTAGGCGGAATTCGTGGTGT	TGCTGGCACGGAGTTAGCCGAT
Pig46Fw:Pig55Rv	AGGTAGGCGGAATTCGTGGTGT	TTACAACCCATAGGGCCGTCAT
Pig46Fw:Pig56Rv	AGGTAGGCGGAATTCGTGGTGT	GTTCCTCCTAATATCTACGCAT
Pig46Fw:Pig57Rv	AGGTAGGCGGAATTCGTGGTGT	GCTGGTTCAGACTTCCGTCCAT
Pig46Fw:Pig58Rv	AGGTAGGCGGAATTCGTGGTGT	GCTGGTTCAGACTTACGTCCAT
Pig46Fw:Pig59Rv	AGGTAGGCGGAATTCGTGGTGT	CGCCACTGGTGTTCCTCCTAAT
Pig46Fw:Pig60Rv	AGGTAGGCGGAATTCGTGGTGT	ATTTCACCGCTACACTAGGAAT
Pig46Fw:Pig61Rv	AGGTAGGCGGAATTCGTGGTGT	TACGGTAAGCTGCCTTCGCAAT
Pig46Fw:Pig62Rv	AGGTAGGCGGAATTCGTGGTGT	CTACGCTCCCTTTAAACCCAAT
Pig46Fw:Pig63Rv	AGGTAGGCGGAATTCGTGGTGT	CAGTAAATCCGGACAACGCTTG
Pig46Fw:Pig64Rv	AGGTAGGCGGAATTCGTGGTGT	CCGTCATCCTGCACGCTACTTG
Pig46Fw:Pig65Rv	AGGTAGGCGGAATTCGTGGTGT	TGGTTCAGACTTCCGTCCATTG
Pig46Fw:Pig66Rv	AGGTAGGCGGAATTCGTGGTGT	TGGTTCAGACTTACGTCCATTG
Pig46Fw:Pig67Rv	AGGTAGGCGGAATTCGTGGTGT	TGCCTTCGCAATCGGAGTTCTG
Pig46Fw:Pig68Rv	AGGTAGGCGGAATTCGTGGTGT	TTCCGTATTACCGCGGCTGCTG
Pig46Fw:Pig69Rv	AGGTAGGCGGAATTCGTGGTGT	CTACGTATTACCGCGGCTGCTG
Pig46Fw:Pig70Rv	AGGTAGGCGGAATTCGTGGTGT	CATCCTGCACGCTACTTGGCTG
Pig46Fw:Pig71Rv	AGGTAGGCGGAATTCGTGGTGT	ACCTTCCGTATTACCGCGGCTG
Pig46Fw:Pig72Rv	AGGTAGGCGGAATTCGTGGTGT	ATCCTCCGTATTACCGCGGCTG
Pig46Fw:Pig73Rv	AGGTAGGCGGAATTCGTGGTGT	CACCTACGTATTACCGCGGCTG
Pig46Fw:Pig74Rv	AGGTAGGCGGAATTCGTGGTGT	AACCCATAGGGCCGTCATCCTG
Pig46Fw:Pig75Rv	AGGTAGGCGGAATTCGTGGTGT	GTCCTTATTCATGCGGTACCTG
Pig46Fw:Pig76Rv	AGGTAGGCGGAATTCGTGGTGT	AATTAGCCGGTCCTTATTCATG
Pig46Fw:Pig77Rv	AGGTAGGCGGAATTCGTGGTGT	CGTCATCCTGCACGCTACTTGG
Pig46Fw:Pig78Rv	AGGTAGGCGGAATTCGTGGTGT	TACGTATTACCGCGGCTGCTGG
Pig46Fw:Pig79Rv	AGGTAGGCGGAATTCGTGGTGT	ATCCTGCACGCTACTTGGCTGG
Pig46Fw:Pig80Rv	AGGTAGGCGGAATTCGTGGTGT	AAGCAGTTTACAACCCATAGGG
Pig46Fw:Pig81Rv	AGGTAGGCGGAATTCGTGGTGT	GGTAAGCTGCCTTCGCAATCGG
Pig46Fw:Pig82Rv	AGGTAGGCGGAATTCGTGGTGT	TAGCCGGTCCTTATTCATGCGG
Pig46Fw:Pig83Rv	AGGTAGGCGGAATTCGTGGTGT	TGCCACCTACGTATTACCGCGG
Pig46Fw:Pig84Rv	AGGTAGGCGGAATTCGTGGTGT	CGCATTTCACCGCTACACTAGG
Pig46Fw:Pig85Rv	AGGTAGGCGGAATTCGTGGTGT	AAAGCAGTTTACAACCCATAGG
Pig46Fw:Pig86Rv	AGGTAGGCGGAATTCGTGGTGT	ACGCTACGGTAAGCTGCCTTCG
Pig46Fw:Pig87Rv	AGGTAGGCGGAATTCGTGGTGT	CGGTAAGCTGCCTTCGCAATCG
Pig46Fw:Pig88Rv	AGGTAGGCGGAATTCGTGGTGT	TTAGCCGGTCCTTATTCATGCG
Pig46Fw:Pig89Rv	AGGTAGGCGGAATTCGTGGTGT	TCGCATCCTCCGTATTACCGCG
Pig46Fw:Pig90Rv	AGGTAGGCGGAATTCGTGGTGT	TTGCCACCTACGTATTACCGCG
Pig46Fw:Pig91Rv	AGGTAGGCGGAATTCGTGGTGT	TCGCCACCTACGTATTACCGCG
Pig46Fw:Pig92Rv	AGGTAGGCGGAATTCGTGGTGT	CAGTTTACAACCCATAGGGCCG
Pig46Fw:Pig93Rv	AGGTAGGCGGAATTCGTGGTGT	GCTCGCATCCTCCGTATTACCG
Pig46Fw:Pig94Rv	AGGTAGGCGGAATTCGTGGTGT	GCTTGCCACCTACGTATTACCG
Pig46Fw:Pig95Rv	AGGTAGGCGGAATTCGTGGTGT	GCTCGCCACCTACGTATTACCG
Pig46Fw:Pig96Rv	AGGTAGGCGGAATTCGTGGTGT	CTAATATCTACGCATTTCACCG
Pig46Fw:Pig97Rv	AGGTAGGCGGAATTCGTGGTGT	GGTGTTCCTCCTAATATCTACG
Pig46Fw:Pig98Rv	AGGTAGGCGGAATTCGTGGTGT	CACCCAGTAAATCCGGACAACG
Pig46Fw:Pig99Rv	AGGTAGGCGGAATTCGTGGTGT	ACGCATTTCACCGCTACACTAG
Pig46Fw:Pig100Rv	AGGTAGGCGGAATTCGTGGTGT	TAAGCTGCCTTCGCAATCGGAG
Pig46Fw:Pig101Rv	AGGTAGGCGGAATTCGTGGTGT	GCACGCTACTTGGCTGGTTCAG
Pig46Fw:Pig102Rv	AGGTAGGCGGAATTCGTGGTGT	TCACGCGACTTGGCTGGTTCAG
Pig46Fw:Pig103Rv	AGGTAGGCGGAATTCGTGGTGT	TACCCGCACTTTCGAGCTTCAG
Pig46Fw:Pig104Rv	AGGTAGGCGGAATTCGTGGTGT	GGAGTTCTTCGTGATATCTAAG
Pig46Fw:Pig105Rv	AGGTAGGCGGAATTCGTGGTGT	CCTCCTAATATCTACGCATTTC
Pig46Fw:Pig106Rv	AGGTAGGCGGAATTCGTGGTGT	CTGCACGCTACTTGGCTGGTTC
Pig46Fw:Pig107Rv	AGGTAGGCGGAATTCGTGGTGT	GCTGCCTTCGCAATCGGAGTTC
Pig46Fw:Pig108Rv	AGGTAGGCGGAATTCGTGGTGT	GATACCCGCACTTTCGAGCTTC
Pig46Fw:Pig109Rv	AGGTAGGCGGAATTCGTGGTGT	AACGCTACGGTAAGCTGCCTTC
Pig46Fw:Pig110Rv	AGGTAGGCGGAATTCGTGGTGT	TTCACCGCTACACTAGGAATTC
